date,deaths,death_0_1_month,death_2_month_2_years,death_3_11_years,death_12_17_years,death_18_64_years,death_65_85_years,death_more_than_85_years,reported,severe,injuries,death_3_12_years,total_deaths,total_reported,total_injuries,total_severe,total_death_0_1_month,total_death_2_month_2_years,total_death_3_11_years,total_death_12_17_years,total_death_18_64_years,total_death_65_85_years,total_death_more_than_85_years
2021-01-11,0,0,0,0,0,0,0,0,5,4,12,0,0,5,12,4,0,0,0,0,0,0,0
2021-01-12,0,0,0,0,0,0,0,0,5,0,16,0,0,10,28,4,0,0,0,0,0,0,0
2021-01-13,0,0,0,0,0,0,0,0,3,0,8,0,0,13,36,4,0,0,0,0,0,0,0
2021-01-14,0,0,0,0,0,0,0,0,3,0,12,0,0,16,48,4,0,0,0,0,0,0,0
2021-01-15,0,0,0,0,0,0,0,0,4,14,18,0,0,20,66,18,0,0,0,0,0,0,0
2021-01-18,0,0,0,0,0,0,0,0,3,8,11,0,0,23,77,26,0,0,0,0,0,0,0
2021-01-19,0,0,0,0,0,0,0,0,11,40,47,0,0,34,124,66,0,0,0,0,0,0,0
2021-01-20,0,0,0,0,0,0,0,0,35,136,136,0,0,69,260,202,0,0,0,0,0,0,0
2021-01-21,0,0,0,0,0,0,0,0,28,123,115,0,0,97,375,325,0,0,0,0,0,0,0
2021-01-22,0,0,0,0,0,0,0,0,30,144,136,0,0,127,511,469,0,0,0,0,0,0,0
2021-01-25,0,0,0,0,0,0,0,0,5,18,19,0,0,132,530,487,0,0,0,0,0,0,0
2021-01-26,1,0,0,0,0,0,0,1,7,71,27,0,1,139,557,558,0,0,0,0,0,0,1
2021-01-27,2,0,0,0,0,1,0,1,26,85,74,0,3,165,631,643,0,0,0,0,1,0,2
2021-01-28,8,0,0,0,0,0,2,6,28,121,110,0,11,193,741,764,0,0,0,0,1,2,8
2021-01-29,2,0,0,0,0,1,0,1,181,711,667,0,13,374,1408,1475,0,0,0,0,2,2,9
2021-01-30,0,0,0,0,0,0,0,0,20,93,90,0,13,394,1498,1568,0,0,0,0,2,2,9
2021-01-31,0,0,0,0,0,0,0,0,14,35,33,0,13,408,1531,1603,0,0,0,0,2,2,9
2021-02-01,1,0,0,0,0,1,0,0,87,284,266,0,14,495,1797,1887,0,0,0,0,3,2,9
2021-02-02,0,0,0,0,0,0,0,0,267,997,954,0,14,762,2751,2884,0,0,0,0,3,2,9
2021-02-03,13,0,0,0,0,0,9,4,224,822,824,0,27,986,3575,3706,0,0,0,0,3,11,13
2021-02-04,0,0,0,0,0,0,0,0,194,781,743,0,27,1180,4318,4487,0,0,0,0,3,11,13
2021-02-05,5,0,0,0,0,0,0,5,225,831,793,0,32,1405,5111,5318,0,0,0,0,3,11,18
2021-02-08,1,0,0,0,0,0,0,1,335,1335,1331,0,33,1740,6442,6653,0,0,0,0,3,11,19
2021-02-09,4,0,0,0,0,0,3,1,347,1400,1360,0,37,2087,7802,8053,0,0,0,0,3,14,20
2021-02-10,5,0,0,0,0,0,1,4,221,846,840,0,42,2308,8642,8899,0,0,0,0,3,15,24
2021-02-11,2,0,0,0,0,0,2,0,194,390,627,0,44,2502,9269,9289,0,0,0,0,3,17,24
2021-02-12,0,0,0,0,0,0,0,0,235,658,863,0,44,2737,10132,9947,0,0,0,0,3,17,24
2021-02-13,5,0,0,0,0,1,3,1,192,660,665,0,49,2929,10797,10607,0,0,0,0,4,20,25
2021-02-14,6,0,0,0,0,1,4,1,81,365,342,0,55,3010,11139,10972,0,0,0,0,5,24,26
2021-02-15,17,0,0,0,0,2,10,5,259,837,989,0,72,3269,12128,11809,0,0,0,0,7,34,31
2021-02-16,2,0,0,0,0,1,0,1,394,900,1298,0,74,3663,13426,12709,0,0,0,0,8,34,32
2021-02-17,14,0,0,0,0,1,9,3,452,1171,1646,0,88,4115,15072,13880,0,0,0,0,9,43,35
2021-02-18,13,0,0,0,0,0,12,0,601,2116,2420,0,101,4716,17492,15996,0,0,0,0,9,55,35
2021-02-19,2,0,0,0,0,0,2,0,928,1701,2865,0,103,5644,20357,17697,0,0,0,0,9,57,35
2021-02-20,6,0,0,0,0,1,2,3,415,713,1307,0,109,6059,21664,18410,0,0,0,0,10,59,38
2021-02-21,5,0,0,0,0,0,0,5,70,28,257,0,114,6129,21921,18438,0,0,0,0,10,59,43
2021-02-22,7,0,0,0,0,2,1,3,631,1676,2396,0,121,6760,24317,20114,0,0,0,0,12,60,46
2021-02-23,18,0,0,0,0,0,2,16,975,2640,3604,0,139,7735,27921,22754,0,0,0,0,12,62,62
2021-02-24,16,0,0,0,0,1,8,6,776,2770,3332,0,155,8511,31253,25524,0,0,0,0,13,70,68
2021-02-25,3,0,0,0,0,1,2,0,1036,3264,4463,0,158,9547,35716,28788,0,0,0,0,14,72,68
2021-02-26,6,0,0,0,0,4,0,1,914,3006,3906,0,164,10461,39622,31794,0,0,0,0,18,72,69
2021-02-27,7,0,0,0,0,3,1,1,1167,1466,2901,0,171,11628,42523,33260,0,0,0,0,21,73,70
2021-02-28,0,0,0,0,0,0,0,0,218,439,968,0,171,11846,43491,33699,0,0,0,0,21,73,70
2021-03-01,4,0,0,0,0,2,1,1,1087,3829,4430,0,175,12933,47921,37528,0,0,0,0,23,74,71
2021-03-02,6,0,0,0,0,1,2,2,1347,4048,5322,0,181,14280,53243,41576,0,0,0,0,24,76,73
2021-03-03,4,0,0,0,0,1,1,2,1433,4561,5953,0,185,15713,59196,46137,0,0,0,0,25,77,75
2021-03-04,13,0,0,0,0,5,5,2,1355,4366,6040,0,198,17068,65236,50503,0,0,0,0,30,82,77
2021-03-05,3,0,0,0,0,0,0,3,695,487,2861,0,201,17763,68097,50990,0,0,0,0,30,82,80
2021-03-06,102,0,0,0,0,2,41,54,18575,60689,78921,0,303,36338,147018,111679,0,0,0,0,32,123,134
2021-03-07,4,0,0,0,0,1,0,2,9411,38594,42027,0,307,45749,189045,150273,0,0,0,0,33,123,136
2021-03-08,4,0,0,0,0,2,0,0,560,894,2486,0,311,46309,191531,151167,0,0,0,0,35,123,136
2021-03-09,3,0,0,0,0,1,2,0,1589,1290,4789,0,314,47898,196320,152457,0,0,0,0,36,125,136
2021-03-10,3,0,0,0,0,1,2,0,1067,981,3853,0,317,48965,200173,153438,0,0,0,0,37,127,136
2021-03-11,24,0,0,0,0,21,3,0,930,825,3369,0,341,49895,203542,154263,0,0,0,0,58,130,136
2021-03-12,2,0,0,0,0,0,0,2,817,833,3699,0,343,50712,207241,155096,0,0,0,0,58,130,138
2021-03-13,18,0,0,0,0,6,11,1,3911,12111,17629,0,361,54623,224870,167207,0,0,0,0,64,141,139
2021-03-14,24,0,0,0,0,4,9,11,7447,29380,33392,0,385,62070,258262,196587,0,0,0,0,68,150,150
2021-03-15,6,0,0,0,0,1,2,3,960,925,4515,0,391,63030,262777,197512,0,0,0,0,69,152,153
2021-03-16,21,0,0,0,0,10,1,10,1361,1090,5550,0,412,64391,268327,198602,0,0,0,0,79,153,163
2021-03-17,35,0,0,0,0,3,18,11,7769,24438,32629,0,447,72160,300956,223040,0,0,0,0,82,171,174
2021-03-18,17,0,0,0,0,5,10,0,1236,1182,5353,0,464,73396,306309,224222,0,0,0,0,87,181,174
2021-03-19,27,0,0,0,0,23,3,1,1913,1264,8488,0,491,75309,314797,225486,0,0,0,0,110,184,175
2021-03-20,134,0,0,0,0,48,54,24,13307,51896,59106,0,625,88616,373903,277382,0,0,0,0,158,238,199
2021-03-21,1,0,0,0,0,0,0,0,776,318,4738,0,626,89392,378641,277700,0,0,0,0,158,238,199
2021-03-22,23,0,0,0,0,4,10,9,1471,1225,7652,0,649,90863,386293,278925,0,0,0,0,162,248,208
2021-03-23,39,0,0,0,0,10,24,5,3162,1905,13501,0,688,94025,399794,280830,0,0,0,0,172,272,213
2021-03-24,51,0,0,0,0,21,17,12,2137,1150,9855,0,739,96162,409649,281980,0,0,0,0,193,289,225
2021-03-25,19,0,0,0,0,13,0,5,2149,1542,10500,0,758,98311,420149,283522,0,0,0,0,206,289,230
2021-03-26,24,0,0,0,0,13,9,0,1678,1369,9184,0,782,99989,429333,284891,0,0,0,0,219,298,230
2021-03-27,134,0,0,0,0,14,75,33,15628,66053,70195,0,916,115617,499528,350944,0,0,0,0,233,373,263
2021-03-28,0,0,0,0,0,0,0,0,986,298,5995,0,916,116603,505523,351242,0,0,0,0,233,373,263
2021-03-29,15,0,0,0,0,2,7,6,2230,1837,10293,0,931,118833,515816,353079,0,0,0,0,235,380,269
2021-03-30,24,0,0,0,0,6,16,0,2240,1851,9832,0,955,121073,525648,354930,0,0,0,0,241,396,269
2021-03-31,30,0,0,0,0,17,7,6,1814,1601,7092,0,985,122887,532740,356531,0,0,0,0,258,403,275
2021-04-01,20,0,0,0,0,15,4,0,1307,1073,6186,0,1005,124194,538926,357604,0,0,0,0,273,407,275
2021-04-02,27,0,0,0,0,11,16,0,1111,747,3556,0,1032,125305,542482,358351,0,0,0,0,284,423,275
2021-04-03,139,0,0,0,0,90,34,7,11370,46735,50179,0,1171,136675,592661,405086,0,0,0,0,374,457,282
2021-04-04,0,0,0,0,0,0,0,0,197,110,734,0,1171,136872,593395,405196,0,0,0,0,374,457,282
2021-04-05,0,0,0,0,0,0,0,0,947,345,6151,0,1171,137819,599546,405541,0,0,0,0,374,457,282
2021-04-06,12,0,0,0,0,9,1,2,1893,763,10413,0,1183,139712,609959,406304,0,0,0,0,383,458,284
2021-04-07,42,0,0,0,0,15,16,11,4284,1339,24229,0,1225,143996,634188,407643,0,0,0,0,398,474,295
2021-04-08,37,0,0,0,0,19,16,2,1283,864,5517,0,1262,145279,639705,408507,0,0,0,0,417,490,297
2021-04-09,32,0,0,0,0,14,9,9,1409,1023,6113,0,1294,146688,645818,409530,0,0,0,0,431,499,306
2021-04-10,123,0,0,0,0,33,30,39,8558,33036,35323,0,1417,155246,681141,442566,0,0,0,0,464,529,345
2021-04-11,5,0,0,0,0,2,2,0,411,322,2205,0,1422,155657,683346,442888,0,0,0,0,466,531,345
2021-04-12,30,0,0,0,0,4,13,5,1250,861,5776,0,1452,156907,689122,443749,0,0,0,0,470,544,350
2021-04-13,40,0,0,0,0,18,11,11,1721,1233,8012,0,1492,158628,697134,444982,0,0,0,0,488,555,361
2021-04-14,16,0,0,0,0,9,2,0,1971,1149,9344,0,1508,160599,706478,446131,0,0,0,0,497,557,361
2021-04-15,83,0,0,0,0,43,17,22,1397,1093,5795,0,1591,161996,712273,447224,0,0,0,0,540,574,383
2021-04-16,23,0,0,0,0,5,16,0,1724,867,7843,0,1614,163720,720116,448091,0,0,0,0,545,590,383
2021-04-17,189,0,0,0,0,69,78,26,9056,33267,38170,0,1803,172776,758286,481358,0,0,0,0,614,668,409
2021-04-18,0,0,0,0,0,0,0,0,567,174,3442,0,1803,173343,761728,481532,0,0,0,0,614,668,409
2021-04-19,10,0,0,0,0,7,0,2,1352,956,5600,0,1813,174695,767328,482488,0,0,0,0,621,668,411
2021-04-20,38,0,0,0,0,13,7,2,1967,1430,8307,0,1851,176662,775635,483918,0,0,0,0,634,675,413
2021-04-21,52,0,0,0,0,26,23,3,1896,1380,7259,0,1903,178558,782894,485298,0,0,0,0,660,698,416
2021-04-22,43,0,0,0,0,5,9,24,1621,1576,6517,0,1946,180179,789411,486874,0,0,0,0,665,707,440
2021-04-23,34,0,0,0,0,8,19,5,1453,1235,5993,0,1980,181632,795404,488109,0,0,0,0,673,726,445
2021-04-24,187,0,0,0,0,117,58,0,5612,20734,23788,0,2167,187244,819192,508843,0,0,0,0,790,784,445
2021-04-25,11,0,0,0,0,0,4,7,693,299,3849,0,2178,187937,823041,509142,0,0,0,0,790,788,452
2021-04-26,46,0,0,0,0,20,21,3,1429,1566,6317,0,2224,189366,829358,510708,0,0,0,0,810,809,455
2021-04-27,49,0,0,0,0,32,10,6,1361,1505,5373,0,2273,190727,834731,512213,0,0,0,0,842,819,461
2021-04-28,31,0,0,0,0,8,18,4,1593,1443,6250,0,2304,192320,840981,513656,0,0,0,0,850,837,465
2021-04-29,70,0,0,0,0,28,35,7,1330,1215,5628,0,2374,193650,846609,514871,0,0,0,0,878,872,472
2021-04-30,46,0,0,0,0,27,13,2,1473,1374,6595,0,2420,195123,853204,516245,0,0,0,0,905,885,474
2021-05-01,37,0,0,0,0,0,32,5,858,658,4211,0,2457,195981,857415,516903,0,0,0,0,905,917,479
2021-05-02,4,0,0,0,0,4,0,0,581,61,3282,0,2461,196562,860697,516964,0,0,0,0,909,917,479
2021-05-03,44,0,0,0,0,12,21,7,1203,995,4826,0,2505,197765,865523,517959,0,0,0,0,921,938,486
2021-05-04,50,0,0,0,0,23,24,3,1375,1404,5795,0,2555,199140,871318,519363,0,0,0,0,944,962,489
2021-05-05,66,0,0,0,0,31,28,1,1757,1316,7129,0,2621,200897,878447,520679,0,0,0,0,975,990,490
2021-05-06,47,0,0,0,0,10,25,9,1348,1705,5713,0,2668,202245,884160,522384,0,0,0,0,985,1015,499
2021-05-07,71,0,0,0,0,15,32,21,1374,1298,5286,0,2739,203619,889446,523682,0,0,0,0,1000,1047,520
2021-05-08,120,0,0,0,0,82,28,10,5216,18815,21904,0,2859,208835,911350,542497,0,0,0,0,1082,1075,530
2021-05-09,0,0,0,0,0,0,0,0,411,198,2164,0,2859,209246,913514,542695,0,0,0,0,1082,1075,530
2021-05-10,58,0,0,0,0,27,20,7,1573,1403,6203,0,2917,210819,919717,544098,0,0,0,0,1109,1095,537
2021-05-11,65,1,0,0,0,41,23,0,1785,1596,7329,0,2982,212604,927046,545694,1,0,0,0,1150,1118,537
2021-05-12,36,0,0,0,0,18,12,5,1670,1163,6218,0,3018,214274,933264,546857,1,0,0,0,1168,1130,542
2021-05-13,20,0,0,0,0,8,12,0,1040,772,4313,0,3038,215314,937577,547629,1,0,0,0,1176,1142,542
2021-05-14,19,0,0,0,0,5,11,3,1535,992,6400,0,3057,216849,943977,548621,1,0,0,0,1181,1153,545
2021-05-15,189,0,0,0,0,104,66,5,6712,26541,27710,0,3246,223561,971687,575162,1,0,0,0,1285,1219,550
2021-05-16,2,0,0,0,0,0,2,0,370,110,1815,0,3248,223931,973502,575272,1,0,0,0,1285,1221,550
2021-05-17,37,0,0,0,0,13,18,4,1591,1625,5732,0,3285,225522,979234,576897,1,0,0,0,1298,1239,554
2021-05-18,41,0,0,0,0,18,23,0,1799,1663,7623,0,3326,227321,986857,578560,1,0,0,0,1316,1262,554
2021-05-19,37,0,0,0,0,21,15,1,1761,1358,6724,0,3363,229082,993581,579918,1,0,0,0,1337,1277,555
2021-05-20,49,0,0,0,0,17,31,1,1706,1492,6829,0,3412,230788,1000410,581410,1,0,0,0,1354,1308,556
2021-05-21,25,0,0,0,0,10,11,2,1913,1281,7227,0,3437,232701,1007637,582691,1,0,0,0,1364,1319,558
2021-05-22,99,0,0,0,0,61,16,11,5985,21359,22836,0,3536,238686,1030473,604050,1,0,0,0,1425,1335,569
2021-05-23,0,0,0,0,0,0,0,0,217,118,1023,0,3536,238903,1031496,604168,1,0,0,0,1425,1335,569
2021-05-24,14,0,0,0,0,5,5,2,822,686,3330,0,3550,239725,1034826,604854,1,0,0,0,1430,1340,571
2021-05-25,35,0,0,0,0,10,20,2,1307,1043,5481,0,3585,241032,1040307,605897,1,0,0,0,1440,1360,573
2021-05-26,45,0,0,0,0,13,13,18,1920,1066,7042,0,3630,242952,1047349,606963,1,0,0,0,1453,1373,591
2021-05-27,74,0,0,0,0,36,32,5,1598,1582,5731,0,3704,244550,1053080,608545,1,0,0,0,1489,1405,596
2021-05-28,87,0,0,0,0,33,48,5,1759,2398,6688,0,3791,246309,1059768,610943,1,0,0,0,1522,1453,601
2021-05-29,116,0,0,0,0,39,41,29,5429,19783,20569,0,3907,251738,1080337,630726,1,0,0,0,1561,1494,630
2021-05-30,10,0,0,0,0,10,0,0,193,92,863,0,3917,251931,1081200,630818,1,0,0,0,1571,1494,630
2021-05-31,51,0,0,0,0,38,10,1,1625,1399,6336,0,3968,253556,1087536,632217,1,0,0,0,1609,1504,631
2021-06-01,76,0,0,0,0,28,15,17,1445,1247,5664,0,4044,255001,1093200,633464,1,0,0,0,1637,1519,648
2021-06-02,13,0,0,0,0,6,3,0,1592,970,6546,0,4057,256593,1099746,634434,1,0,0,0,1643,1522,648
2021-06-03,32,0,0,0,0,11,21,0,1092,1347,4232,0,4089,257685,1103978,635781,1,0,0,0,1654,1543,648
2021-06-04,226,0,0,0,0,92,82,36,7158,22892,28414,0,4315,264843,1132392,658673,1,0,0,0,1746,1625,684
2021-06-05,83,0,0,0,0,45,21,14,4292,14374,15230,0,4398,269135,1147622,673047,1,0,0,0,1791,1646,698
2021-06-06,0,0,0,0,0,0,0,0,204,186,975,0,4398,269339,1148597,673233,1,0,0,0,1791,1646,698
2021-06-07,100,0,0,0,0,27,73,0,1809,1152,7343,0,4498,271148,1155940,674385,1,0,0,0,1818,1719,698
2021-06-08,50,0,0,0,0,32,15,1,1664,1205,6344,0,4548,272812,1162284,675590,1,0,0,0,1850,1734,699
2021-06-09,48,0,0,0,0,21,15,9,1616,1258,6102,0,4596,274428,1168386,676848,1,0,0,0,1871,1749,708
2021-06-10,82,0,0,0,0,20,44,15,1542,1183,5898,0,4678,275970,1174284,678031,1,0,0,0,1891,1793,723
2021-06-11,27,0,0,0,0,15,6,6,1686,1082,6742,0,4705,277656,1181026,679113,1,0,0,0,1906,1799,729
2021-06-12,127,0,0,0,0,52,56,6,3787,12604,12887,0,4832,281443,1193913,691717,1,0,0,0,1958,1855,735
2021-06-13,6,0,0,0,0,3,1,0,398,512,1679,0,4838,281841,1195592,692229,1,0,0,0,1961,1856,735
2021-06-14,46,0,0,0,0,19,21,4,1645,1149,6425,0,4884,283486,1202017,693378,1,0,0,0,1980,1877,739
2021-06-15,26,0,0,0,0,13,5,7,1538,1233,5871,0,4910,285024,1207888,694611,1,0,0,0,1993,1882,746
2021-06-16,45,0,0,0,0,31,8,3,1414,879,4971,0,4955,286438,1212859,695490,1,0,0,0,2024,1890,749
2021-06-17,42,0,0,0,0,21,15,3,1205,1022,4107,0,4997,287643,1216966,696512,1,0,0,0,2045,1905,752
2021-06-18,86,0,0,0,0,38,39,4,1608,1311,5763,0,5083,289251,1222729,697823,1,0,0,0,2083,1944,756
2021-06-19,133,0,0,0,0,22,68,18,3205,11448,11543,0,5216,292456,1234272,709271,1,0,0,0,2105,2012,774
2021-06-20,2,0,0,0,0,0,2,0,183,230,714,0,5218,292639,1234986,709501,1,0,0,0,2105,2014,774
2021-06-21,18,0,0,0,0,5,6,0,1271,1386,4534,0,5236,293910,1239520,710887,1,0,0,0,2110,2020,774
2021-06-22,40,0,0,0,0,12,19,5,1242,1604,4239,0,5276,295152,1243759,712491,1,0,0,0,2122,2039,779
2021-06-23,40,0,0,0,0,23,16,0,1169,1511,4067,0,5316,296321,1247826,714002,1,0,0,0,2145,2055,779
2021-06-24,65,0,0,0,0,24,31,8,1558,1585,5648,0,5381,297879,1253474,715587,1,0,0,0,2169,2086,787
2021-06-25,71,0,0,0,0,58,5,5,1388,1850,5197,0,5452,299267,1258671,717437,1,0,0,0,2227,2091,792
2021-06-26,126,0,0,0,0,22,72,23,4767,14356,14614,0,5578,304034,1273285,731793,1,0,0,0,2249,2163,815
2021-06-27,8,0,0,0,0,4,4,0,115,116,434,0,5586,304149,1273719,731909,1,0,0,0,2253,2167,815
2021-06-28,87,0,0,0,0,35,36,10,1389,1485,4859,0,5673,305538,1278578,733394,1,0,0,0,2288,2203,825
2021-06-29,60,0,0,0,0,39,10,5,1331,1563,4868,0,5733,306869,1283446,734957,1,0,0,0,2327,2213,830
2021-06-30,24,0,2,0,0,5,13,4,1792,1283,5862,0,5757,308661,1289308,736240,1,2,0,0,2332,2226,834
2021-07-01,37,0,0,0,0,13,22,1,2168,1087,7184,0,5794,310829,1296492,737327,1,2,0,0,2345,2248,835
2021-07-02,77,0,0,0,0,54,16,7,1566,1162,5435,0,5871,312395,1301927,738489,1,2,0,0,2399,2264,842
2021-07-03,92,0,0,0,0,60,10,10,3350,10646,10852,0,5963,315745,1312779,749135,1,2,0,0,2459,2274,852
2021-07-04,10,0,0,0,0,7,3,0,107,136,430,0,5973,315852,1313209,749271,1,2,0,0,2466,2277,852
2021-07-05,30,0,0,0,0,21,9,0,1367,934,4716,0,6003,317219,1317925,750205,1,2,0,0,2487,2286,852
2021-07-06,36,0,0,0,0,14,14,8,1201,1077,4218,0,6039,318420,1322143,751282,1,2,0,0,2501,2300,860
2021-07-07,27,0,0,0,0,19,8,0,1110,923,4138,0,6066,319530,1326281,752205,1,2,0,0,2520,2308,860
2021-07-08,22,0,0,0,0,15,3,2,1287,738,4751,0,6088,320817,1331032,752943,1,2,0,0,2535,2311,862
2021-07-09,78,2,0,0,0,31,37,6,1160,847,4346,0,6166,321977,1335378,753790,3,2,0,0,2566,2348,868
2021-07-10,65,0,0,0,0,22,31,9,2495,8649,8541,0,6231,324472,1343919,762439,3,2,0,0,2588,2379,877
2021-07-11,0,0,0,0,0,0,0,0,93,114,345,0,6231,324565,1344264,762553,3,2,0,0,2588,2379,877
2021-07-12,55,0,0,0,0,22,29,2,947,760,3211,0,6286,325512,1347475,763313,3,2,0,0,2610,2408,879
2021-07-13,10,0,0,0,0,5,3,1,817,667,2809,0,6296,326329,1350284,763980,3,2,0,0,2615,2411,880
2021-07-14,13,0,0,0,0,12,1,0,564,459,2053,0,6309,326893,1352337,764439,3,2,0,0,2627,2412,880
2021-07-15,11,0,0,0,0,3,5,1,534,632,1864,0,6320,327427,1354201,765071,3,2,0,0,2630,2417,881
2021-07-16,51,0,0,0,0,21,17,7,628,784,2299,0,6371,328055,1356500,765855,3,2,0,0,2651,2434,888
2021-07-17,156,0,0,0,0,82,59,10,2160,8527,7734,0,6527,330215,1364234,774382,3,2,0,0,2733,2493,898
2021-07-18,0,0,0,0,0,0,0,0,32,61,93,0,6527,330247,1364327,774443,3,2,0,0,2733,2493,898
2021-07-19,85,0,0,0,0,42,22,0,613,902,2236,0,6612,330860,1366563,775345,3,2,0,0,2775,2515,898
2021-07-20,51,0,0,0,0,34,16,0,1597,2616,5392,0,6663,332457,1371955,777961,3,2,0,0,2809,2531,898
2021-07-21,10,0,0,0,0,6,4,0,553,731,2090,0,6673,333010,1374045,778692,3,2,0,0,2815,2535,898
2021-07-22,23,0,0,0,0,19,4,0,624,823,2304,0,6696,333634,1376349,779515,3,2,0,0,2834,2539,898
2021-07-23,80,0,0,0,0,55,20,5,694,787,2472,0,6776,334328,1378821,780302,3,2,0,0,2889,2559,903
2021-07-24,126,0,0,0,0,46,55,7,1698,6513,6108,0,6902,336026,1384929,786815,3,2,0,0,2935,2614,910
2021-07-25,0,0,0,0,0,0,0,0,66,49,252,0,6902,336092,1385181,786864,3,2,0,0,2935,2614,910
2021-07-26,45,0,0,0,0,24,12,6,578,973,2129,0,6947,336670,1387310,787837,3,2,0,0,2959,2626,916
2021-07-27,20,0,0,0,0,8,12,0,605,917,2346,0,6967,337275,1389656,788754,3,2,0,0,2967,2638,916
2021-07-28,48,0,0,0,0,10,25,5,5027,4615,22790,0,7015,342302,1412446,793369,3,2,0,0,2977,2663,921
2021-07-29,35,0,0,0,0,12,12,0,822,1512,2994,0,7050,343124,1415440,794881,3,2,0,0,2989,2675,921
2021-07-30,28,0,0,0,0,12,15,1,819,1146,3002,0,7078,343943,1418442,796027,3,2,0,0,3001,2690,922
2021-07-31,166,0,0,0,0,66,67,31,1293,5416,4582,0,7244,345236,1423024,801443,3,2,0,0,3067,2757,953
2021-08-01,0,0,0,0,0,0,0,0,40,127,168,0,7244,345276,1423192,801570,3,2,0,0,3067,2757,953
2021-08-02,53,0,0,0,0,27,23,1,955,800,3540,0,7297,346231,1426732,802370,3,2,0,0,3094,2780,954
2021-08-03,37,0,0,0,0,2,33,1,860,1262,3243,0,7334,347091,1429975,803632,3,2,0,0,3096,2813,955
2021-08-04,23,0,0,0,0,13,9,1,857,996,3199,0,7357,347948,1433174,804628,3,2,0,0,3109,2822,956
2021-08-05,27,0,0,0,0,9,4,14,665,674,2489,0,7384,348613,1435663,805302,3,2,0,0,3118,2826,970
2021-08-06,45,0,0,0,0,8,35,2,717,977,2741,0,7429,349330,1438404,806279,3,2,0,0,3126,2861,972
2021-08-07,87,0,0,0,0,32,27,11,1178,5057,4284,0,7516,350508,1442688,811336,3,2,0,0,3158,2888,983
2021-08-08,3,0,0,0,0,3,0,0,46,76,165,0,7519,350554,1442853,811412,3,2,0,0,3161,2888,983
2021-08-09,81,0,0,0,0,39,42,0,643,783,2601,0,7600,351197,1445454,812195,3,2,0,0,3200,2930,983
2021-08-10,49,0,0,0,0,46,2,0,794,954,3097,0,7649,351991,1448551,813149,3,2,0,0,3246,2932,983
2021-08-11,27,0,0,0,0,18,9,0,875,773,3430,0,7676,352866,1451981,813922,3,2,0,0,3264,2941,983
2021-08-12,43,0,0,0,0,18,23,2,868,830,2801,0,7719,353734,1454782,814752,3,2,0,0,3282,2964,985
2021-08-13,57,0,0,0,0,37,15,5,627,853,2307,0,7776,354361,1457089,815605,3,2,0,0,3319,2979,990
2021-08-14,64,0,0,0,0,38,18,6,932,3633,3126,0,7840,355293,1460215,819238,3,2,0,0,3357,2997,996
2021-08-15,0,0,0,0,0,0,0,0,50,52,185,0,7840,355343,1460400,819290,3,2,0,0,3357,2997,996
2021-08-16,26,0,0,0,0,8,14,0,537,944,2006,0,7866,355880,1462406,820234,3,2,0,0,3365,3011,996
2021-08-17,82,0,0,0,0,54,23,5,730,1202,2549,0,7948,356610,1464955,821436,3,2,0,0,3419,3034,1001
2021-08-18,20,0,0,0,0,11,8,1,681,650,2160,0,7968,357291,1467115,822086,3,2,0,0,3430,3042,1002
2021-08-19,26,0,0,0,0,15,10,0,598,1123,2163,0,7994,357889,1469278,823209,3,2,0,0,3445,3052,1002
2021-08-20,49,0,0,0,0,24,16,8,456,740,1700,0,8043,358345,1470978,823949,3,2,0,0,3469,3068,1010
2021-08-21,78,0,0,0,0,52,24,0,660,2678,2277,0,8121,359005,1473255,826627,3,2,0,0,3521,3092,1010
2021-08-22,0,0,0,0,0,0,0,0,38,45,143,0,8121,359043,1473398,826672,3,2,0,0,3521,3092,1010
2021-08-23,30,0,0,0,0,9,13,3,710,1263,2585,0,8151,359753,1475983,827935,3,2,0,0,3530,3105,1013
2021-08-24,41,0,0,0,0,29,11,0,975,1863,3393,0,8192,360728,1479376,829798,3,2,0,0,3559,3116,1013
2021-08-25,13,1,0,0,2,4,4,2,660,1447,2293,0,8205,361388,1481669,831245,4,2,0,2,3563,3120,1015
2021-08-26,38,0,0,0,0,16,18,4,804,1743,2884,0,8243,362192,1484553,832988,4,2,0,2,3579,3138,1019
2021-08-27,101,0,0,0,0,42,58,1,786,2371,2793,0,8344,362978,1487346,835359,4,2,0,2,3621,3196,1020
2021-08-28,18,0,0,0,0,7,11,0,193,697,758,0,8362,363171,1488104,836056,4,2,0,2,3628,3207,1020
2021-08-29,3,0,0,0,0,0,3,0,73,36,307,0,8365,363244,1488411,836092,4,2,0,2,3628,3210,1020
2021-08-30,45,0,0,0,0,28,15,0,618,1641,2304,0,8410,363862,1490715,837733,4,2,0,2,3656,3225,1020
2021-08-31,27,0,0,0,0,15,12,0,633,1568,2351,0,8437,364495,1493066,839301,4,2,0,2,3671,3237,1020
2021-09-01,61,0,0,0,0,37,22,0,784,1956,3014,0,8498,365279,1496080,841257,4,2,0,2,3708,3259,1020
2021-09-02,27,0,0,0,0,10,16,0,1111,2892,4667,0,8525,366390,1500747,844149,4,2,0,2,3718,3275,1020
2021-09-03,45,0,0,0,0,37,6,0,533,1364,2287,0,8570,366923,1503034,845513,4,2,0,2,3755,3281,1020