date,deaths,death_0_1_month,death_2_month_2_years,death_3_11_years,death_12_17_years,death_18_64_years,death_65_85_years,death_more_than_85_years,reported,severe,injuries,total_deaths,total_reported,total_injuries,total_severe,total_death_0_1_month,total_death_2_month_2_years,total_death_3_11_years,total_death_12_17_years,total_death_18_64_years,total_death_65_85_years,total_death_more_than_85_years
2020-12-10,0,0,0,0,0,0,0,0,1,0,2,0,1,2,0,0,0,0,0,0,0,0
2020-12-11,0,0,0,0,0,0,0,0,14,9,40,0,15,42,9,0,0,0,0,0,0,0
2020-12-14,0,0,0,0,0,0,0,0,107,114,357,0,122,399,123,0,0,0,0,0,0,0
2020-12-15,0,0,0,0,0,0,0,0,110,118,324,0,232,723,241,0,0,0,0,0,0,0
2020-12-16,0,0,0,0,0,0,0,0,77,83,277,0,309,1000,324,0,0,0,0,0,0,0
2020-12-17,0,0,0,0,0,0,0,0,91,151,318,0,400,1318,475,0,0,0,0,0,0,0
2020-12-18,0,0,0,0,0,0,0,0,99,86,295,0,499,1613,561,0,0,0,0,0,0,0
2020-12-21,0,0,0,0,0,0,0,0,282,399,943,0,781,2556,960,0,0,0,0,0,0,0
2020-12-22,0,0,0,0,0,0,0,0,168,215,525,0,949,3081,1175,0,0,0,0,0,0,0
2020-12-23,7,0,0,0,0,0,1,0,272,358,832,7,1221,3913,1533,0,0,0,0,0,1,0
2020-12-24,4,0,0,0,0,0,2,2,191,270,563,11,1412,4476,1803,0,0,0,0,0,3,2
2020-12-25,5,0,0,0,0,4,0,1,219,344,682,16,1631,5158,2147,0,0,0,0,4,3,3
2020-12-28,0,0,0,0,0,0,0,0,74,131,260,16,1705,5418,2278,0,0,0,0,4,3,3
2020-12-29,0,0,0,0,0,0,0,0,118,126,353,16,1823,5771,2404,0,0,0,0,4,3,3
2020-12-30,1,0,0,0,0,0,0,1,402,454,1258,17,2225,7029,2858,0,0,0,0,4,3,4
2020-12-31,0,0,0,0,0,0,0,0,215,362,714,17,2440,7743,3220,0,0,0,0,4,3,4
2021-01-01,0,0,0,0,0,0,0,0,24,13,64,17,2464,7807,3233,0,0,0,0,4,3,4
2021-01-02,0,0,0,0,0,0,0,0,19,30,59,17,2483,7866,3263,0,0,0,0,4,3,4
2021-01-03,0,0,0,0,0,0,0,0,3,3,8,17,2486,7874,3266,0,0,0,0,4,3,4
2021-01-04,8,0,0,0,0,0,6,2,207,251,691,25,2693,8565,3517,0,0,0,0,4,9,6
2021-01-05,3,0,0,0,0,2,0,1,148,119,408,28,2841,8973,3636,0,0,0,0,6,9,7
2021-01-06,3,0,0,0,0,0,1,2,191,161,512,31,3032,9485,3797,0,0,0,0,6,10,9
2021-01-07,13,0,0,0,0,1,2,10,236,242,664,44,3268,10149,4039,0,0,0,0,7,12,19
2021-01-08,9,0,0,0,0,0,8,1,346,313,909,53,3614,11058,4352,0,0,0,0,7,20,20
2021-01-09,0,0,0,0,0,0,0,0,141,14,337,53,3755,11395,4366,0,0,0,0,7,20,20
2021-01-10,0,0,0,0,0,0,0,0,38,6,74,53,3793,11469,4372,0,0,0,0,7,20,20
2021-01-11,4,0,0,0,0,0,0,4,415,524,1377,57,4208,12846,4896,0,0,0,0,7,20,24
2021-01-12,11,0,0,0,0,4,4,3,672,530,2029,68,4880,14875,5426,0,0,0,0,11,24,27
2021-01-13,15,0,0,0,0,0,4,11,776,801,2303,83,5656,17178,6227,0,0,0,0,11,28,38
2021-01-14,7,0,0,0,0,0,4,0,755,747,2284,90,6411,19462,6974,0,0,0,0,11,32,38
2021-01-15,22,0,0,0,0,2,10,10,671,833,2274,112,7082,21736,7807,0,0,0,0,13,42,48
2021-01-16,0,0,0,0,0,0,0,0,39,26,131,112,7121,21867,7833,0,0,0,0,13,42,48
2021-01-17,6,0,0,0,0,0,0,6,203,66,499,118,7324,22366,7899,0,0,0,0,13,42,54
2021-01-18,23,0,0,0,0,1,16,6,884,1142,2953,141,8208,25319,9041,0,0,0,0,14,58,60
2021-01-19,35,0,0,0,0,0,17,16,866,1044,2787,176,9074,28106,10085,0,0,0,0,14,75,76
2021-01-20,21,0,0,0,0,2,2,17,756,1122,2553,197,9830,30659,11207,0,0,0,0,16,77,93
2021-01-21,41,0,0,0,0,0,8,33,1035,1280,3352,238,10865,34011,12487,0,0,0,0,16,85,126
2021-01-22,43,0,0,0,0,7,7,29,2357,1240,7127,281,13222,41138,13727,0,0,0,0,23,92,155
2021-01-23,4,0,0,0,0,0,0,4,1016,233,2994,285,14238,44132,13960,0,0,0,0,23,92,159
2021-01-24,1,0,0,0,0,0,1,0,121,48,376,286,14359,44508,14008,0,0,0,0,23,93,159
2021-01-25,38,0,0,0,0,0,13,21,952,1270,3116,324,15311,47624,15278,0,0,0,0,23,106,180
2021-01-26,45,0,0,0,0,2,9,34,1929,1539,6305,369,17240,53929,16817,0,0,0,0,25,115,214
2021-01-27,40,0,0,0,0,4,13,23,1571,1354,4946,409,18811,58875,18171,0,0,0,0,29,128,237
2021-01-28,73,0,0,0,0,6,27,40,1805,1741,5633,482,20616,64508,19912,0,0,0,0,35,155,277
2021-01-29,71,0,0,0,0,3,18,48,2021,2362,6511,553,22637,71019,22274,0,0,0,0,38,173,325
2021-01-30,13,0,0,0,0,1,3,9,1135,424,3694,566,23772,74713,22698,0,0,0,0,39,176,334
2021-01-31,3,0,0,0,0,0,0,3,382,102,1325,569,24154,76038,22800,0,0,0,0,39,176,337
2021-02-01,79,0,0,0,0,6,27,40,1781,3049,6293,648,25935,82331,25849,0,0,0,0,45,203,377
2021-02-02,40,0,0,0,0,0,14,25,2736,4200,9793,688,28671,92124,30049,0,0,0,0,45,217,402
2021-02-03,57,0,0,0,0,6,28,23,2281,3477,8218,745,30952,100342,33526,0,0,0,0,51,245,425
2021-02-04,37,0,0,0,0,2,11,24,2731,2990,9264,782,33683,109606,36516,0,0,0,0,53,256,449
2021-02-05,57,0,0,0,0,0,24,32,2101,2122,6884,839,35784,116490,38638,0,0,0,0,53,280,481
2021-02-06,11,0,0,0,0,0,6,5,1269,395,4386,850,37053,120876,39033,0,0,0,0,53,286,486
2021-02-07,2,0,0,0,0,0,0,1,664,474,2268,852,37717,123144,39507,0,0,0,0,53,286,487
2021-02-08,88,0,0,0,0,4,24,60,1834,3988,6806,940,39551,129950,43495,0,0,0,0,57,310,547
2021-02-09,75,0,0,0,0,7,25,38,2983,3466,10273,1015,42534,140223,46961,0,0,0,0,64,335,585
2021-02-10,120,0,0,0,0,17,33,65,2178,2907,6833,1135,44712,147056,49868,0,0,0,0,81,368,650
2021-02-11,129,0,0,0,0,7,40,77,2083,2904,6875,1264,46795,153931,52772,0,0,0,0,88,408,727
2021-02-12,75,0,0,0,0,2,20,52,3455,3170,11638,1339,50250,165569,55942,0,0,0,0,90,428,779
2021-02-13,36,0,0,0,0,1,9,25,2073,998,6698,1375,52323,172267,56940,0,0,0,0,91,437,804
2021-02-14,8,0,0,0,0,1,5,2,872,1363,3641,1383,53195,175908,58303,0,0,0,0,92,442,806
2021-02-15,67,0,0,0,0,13,21,29,1604,3181,5964,1450,54799,181872,61484,0,0,0,0,105,463,835
2021-02-16,146,0,0,0,0,19,64,63,2769,3628,9562,1596,57568,191434,65112,0,0,0,0,124,527,898
2021-02-17,90,0,0,0,0,4,44,40,2567,3866,9464,1686,60135,200898,68978,0,0,0,0,128,571,938
2021-02-18,70,0,0,0,0,14,42,11,2699,4530,10399,1756,62834,211297,73508,0,0,0,0,142,613,949
2021-02-19,89,0,0,0,0,5,23,59,3481,4566,11881,1845,66315,223178,78074,0,0,0,0,147,636,1008
2021-02-20,37,0,0,0,0,5,11,21,1625,1849,5754,1882,67940,228932,79923,0,0,0,0,152,647,1029
2021-02-21,5,0,0,0,0,0,0,5,305,156,1276,1887,68245,230208,80079,0,0,0,0,152,647,1034
2021-02-22,80,0,0,0,0,4,24,47,2214,4630,9042,1967,70459,239250,84709,0,0,0,0,156,671,1081
2021-02-23,99,0,0,0,0,9,30,60,2575,5441,9505,2066,73034,248755,90150,0,0,0,0,165,701,1141
2021-02-24,196,0,0,0,0,14,108,73,2654,6122,10317,2262,75688,259072,96272,0,0,0,0,179,809,1214
2021-02-25,59,0,0,0,0,1,35,18,2427,5566,9839,2321,78115,268911,101838,0,0,0,0,180,844,1232
2021-02-26,72,0,0,0,0,7,3,61,2558,4549,9716,2393,80673,278627,106387,0,0,0,0,187,847,1293
2021-02-27,87,0,0,0,0,12,16,57,2999,2802,7494,2480,83672,286121,109189,0,0,0,0,199,863,1350
2021-02-28,14,0,0,0,0,0,1,12,923,574,3806,2494,84595,289927,109763,0,0,0,0,199,864,1362
2021-03-01,70,0,0,0,0,8,27,35,4024,6297,16082,2564,88619,306009,116060,0,0,0,0,207,891,1397
2021-03-02,132,0,0,0,0,19,73,39,2969,6559,10831,2696,91588,316840,122619,0,0,0,0,226,964,1436
2021-03-03,169,0,0,0,0,30,68,67,3566,8054,13768,2865,95154,330608,130673,0,0,0,0,256,1032,1503
2021-03-04,97,0,0,0,0,9,46,41,3149,8035,12817,2962,98303,343425,138708,0,0,0,0,265,1078,1544
2021-03-05,142,0,0,0,0,16,54,68,3491,3127,14943,3104,101794,358368,141835,0,0,0,0,281,1132,1612
2021-03-06,102,0,0,0,0,2,41,54,19365,61049,81617,3206,121159,439985,202884,0,0,0,0,283,1173,1666
2021-03-07,4,0,0,0,0,1,0,2,9607,38705,42705,3210,130766,482690,241589,0,0,0,0,284,1173,1668
2021-03-08,154,0,0,0,0,17,61,64,3096,3795,12728,3364,133862,495418,245384,0,0,0,0,301,1234,1732
2021-03-09,145,0,0,0,0,26,59,60,4825,5213,14997,3509,138687,510415,250597,0,0,0,0,327,1293,1792
2021-03-10,75,0,0,0,0,7,51,16,4350,3810,16889,3584,143037,527304,254407,0,0,0,0,334,1344,1808
2021-03-11,141,0,0,0,0,53,36,52,3398,3978,12737,3725,146435,540041,258385,0,0,0,0,387,1380,1860
2021-03-12,52,0,0,0,0,5,25,17,2414,2703,10227,3777,148849,550268,261088,0,0,0,0,392,1405,1877
2021-03-13,19,0,0,0,0,6,11,2,4624,12273,20263,3796,153473,570531,273361,0,0,0,0,398,1416,1879
2021-03-14,24,0,0,0,0,4,9,11,7586,29484,33827,3820,161059,604358,302845,0,0,0,0,402,1425,1890
2021-03-15,74,0,0,0,0,2,20,46,2041,2685,8887,3894,163100,613245,305530,0,0,0,0,404,1445,1936
2021-03-16,123,0,0,0,0,20,29,66,3098,4315,12218,4017,166198,625463,309845,0,0,0,0,424,1474,2002
2021-03-17,155,0,0,0,0,12,62,73,10264,26843,40594,4172,176462,666057,336688,0,0,0,0,436,1536,2075
2021-03-18,107,0,0,0,0,7,32,56,2646,3141,10689,4279,179108,676746,339829,0,0,0,0,443,1568,2131
2021-03-19,125,0,0,0,0,45,39,38,4395,4746,18155,4404,183503,694901,344575,0,0,0,0,488,1607,2169
2021-03-20,142,0,0,0,0,48,56,30,14283,52233,63458,4546,197786,758359,396808,0,0,0,0,536,1663,2199
2021-03-21,2,0,0,0,0,0,0,1,1375,514,7690,4548,199161,766049,397322,0,0,0,0,536,1663,2200
2021-03-22,144,0,0,0,0,9,69,63,3105,3930,15750,4692,202266,781799,401252,0,0,0,0,545,1732,2263
2021-03-23,210,0,0,0,0,20,88,94,5982,5612,23651,4902,208248,805450,406864,0,0,0,0,565,1820,2357
2021-03-24,185,0,0,0,0,31,76,77,4166,4131,17266,5087,212414,822716,410995,0,0,0,0,596,1896,2434
2021-03-25,124,0,0,0,0,22,60,41,4436,4023,19993,5211,216850,842709,415018,0,0,0,0,618,1956,2475
2021-03-26,114,0,0,0,0,21,46,44,3032,3455,15055,5325,219882,857764,418473,0,0,0,0,639,2002,2519
2021-03-27,143,0,0,0,0,14,82,35,15937,66168,71106,5468,235819,928870,484641,0,0,0,0,653,2084,2554
2021-03-28,21,0,0,0,0,0,8,13,1599,448,8711,5489,237418,937581,485089,0,0,0,0,653,2092,2567
2021-03-29,185,0,0,0,0,8,84,85,4204,4360,17337,5674,241622,954918,489449,0,0,0,0,661,2176,2652
2021-03-30,207,0,0,0,0,32,65,102,4376,4894,17193,5881,245998,972111,494343,0,0,0,0,693,2241,2754
2021-03-31,197,0,0,0,0,35,84,72,3650,4638,13658,6078,249648,985769,498981,0,0,0,0,728,2325,2826
2021-04-01,160,0,0,0,0,38,68,50,2719,3977,11866,6238,252367,997635,502958,0,0,0,0,766,2393,2876
2021-04-02,136,0,0,0,0,30,54,49,2800,3769,9209,6374,255167,1006844,506727,0,0,0,0,796,2447,2925
2021-04-03,164,0,0,0,0,93,42,21,12157,47042,52082,6538,267324,1058926,553769,0,0,0,0,889,2489,2946
2021-04-04,1,0,0,0,0,0,1,0,320,176,1137,6539,267644,1060063,553945,0,0,0,0,889,2490,2946
2021-04-05,109,0,0,0,0,18,49,41,1960,2613,10562,6648,269604,1070625,556558,0,0,0,0,907,2539,2987
2021-04-06,180,0,0,0,0,45,71,62,3317,3281,15590,6828,272921,1086215,559839,0,0,0,0,952,2610,3049
2021-04-07,233,0,0,0,0,24,104,93,8881,4346,44040,7061,281802,1130255,564185,0,0,0,0,976,2714,3142
2021-04-08,283,0,0,0,0,32,128,55,3229,4588,12583,7344,285031,1142838,568773,0,0,0,0,1008,2842,3197
2021-04-09,187,0,0,0,0,22,51,77,3254,4148,12629,7531,288285,1155467,572921,0,0,0,0,1030,2893,3274
2021-04-10,129,0,0,0,0,34,30,44,9024,33111,36919,7660,297309,1192386,606032,0,0,0,0,1064,2923,3318
2021-04-11,10,0,0,0,0,2,2,2,667,532,3120,7670,297976,1195506,606564,0,0,0,0,1066,2925,3320
2021-04-12,147,0,0,0,0,25,54,59,2770,3803,11250,7817,300746,1206756,610367,0,0,0,0,1091,2979,3379
2021-04-13,242,0,0,0,0,29,82,113,3857,5177,16217,8059,304603,1222973,615544,0,0,0,0,1120,3061,3492
2021-04-14,157,0,0,0,0,35,65,51,4080,4560,17030,8216,308683,1240003,620104,0,0,0,0,1155,3126,3543
2021-04-15,166,0,0,0,0,51,59,50,3058,3668,11864,8382,311741,1251867,623772,0,0,0,0,1206,3185,3593
2021-04-16,97,0,0,0,0,9,44,40,3445,3563,14374,8479,315186,1266241,627335,0,0,0,0,1215,3229,3633
2021-04-17,221,0,0,0,0,70,79,55,9526,33483,39984,8700,324712,1306225,660818,0,0,0,0,1285,3308,3688
2021-04-18,7,0,0,0,0,3,2,2,929,372,4931,8707,325641,1311156,661190,0,0,0,0,1288,3310,3690
2021-04-19,119,0,0,0,0,31,47,37,3231,3838,12186,8826,328872,1323342,665028,0,0,0,0,1319,3357,3727
2021-04-20,127,0,0,0,0,26,30,45,4369,4848,17910,8953,333241,1341252,669876,0,0,0,0,1345,3387,3772
2021-04-21,163,0,0,0,0,56,69,34,4103,4682,15323,9116,337344,1356575,674558,0,0,0,0,1401,3456,3806
2021-04-22,280,0,0,0,0,49,128,93,3580,4629,13267,9396,340924,1369842,679187,0,0,0,0,1450,3584,3899
2021-04-23,163,0,0,0,0,41,95,24,3099,4515,11956,9559,344023,1381798,683702,0,0,0,0,1491,3679,3923
2021-04-24,207,0,0,0,0,125,61,7,5940,21113,25115,9766,349963,1406913,704815,0,0,0,0,1616,3740,3930
2021-04-25,26,0,0,0,0,0,6,10,1130,649,5818,9792,351093,1412731,705464,0,0,0,0,1616,3746,3940
2021-04-26,247,0,0,0,0,55,73,112,3578,5728,14675,10039,354671,1427406,711192,0,0,0,0,1671,3819,4052
2021-04-27,129,0,0,0,0,46,38,44,3773,5230,14128,10168,358444,1441534,716422,0,0,0,0,1717,3857,4096
2021-04-28,190,0,0,0,0,39,90,58,3850,5491,14676,10358,362294,1456210,721913,0,0,0,0,1756,3947,4154
2021-04-29,323,0,0,0,0,102,132,77,3459,4550,13538,10681,365753,1469748,726463,0,0,0,0,1858,4079,4231
2021-04-30,302,0,0,0,1,55,141,86,3568,5229,14356,10983,369321,1484104,731692,0,0,0,1,1913,4220,4317
2021-05-01,49,0,0,0,0,1,35,13,1564,946,6993,11032,370885,1491097,732638,0,0,0,1,1914,4255,4330
2021-05-02,7,0,0,0,0,4,3,0,1061,112,5633,11039,371946,1496730,732750,0,0,0,1,1918,4258,4330
2021-05-03,346,0,0,0,0,83,172,76,3079,4460,11820,11385,375025,1508550,737210,0,0,0,1,2001,4430,4406
2021-05-04,147,0,0,0,0,32,62,36,3448,4909,13228,11532,378473,1521778,742119,0,0,0,1,2033,4492,4442
2021-05-05,226,0,0,0,0,61,111,46,4244,5975,16310,11758,382717,1538088,748094,0,0,0,1,2094,4603,4488
2021-05-06,203,0,0,0,2,47,110,40,3843,6673,15118,11961,386560,1553206,754767,0,0,0,3,2141,4713,4528
2021-05-07,233,0,0,0,0,48,123,55,3797,5610,14531,12194,390357,1567737,760377,0,0,0,3,2189,4836,4583
2021-05-08,152,0,0,0,0,82,45,25,6219,19407,25896,12346,396576,1593633,779784,0,0,0,3,2271,4881,4608
2021-05-09,0,0,0,0,0,0,0,0,755,267,3662,12346,397331,1597295,780051,0,0,0,3,2271,4881,4608
2021-05-10,243,0,0,0,0,81,102,53,3875,6077,14928,12589,401206,1612223,786128,0,0,0,3,2352,4983,4661
2021-05-11,321,1,0,0,0,107,136,66,4603,6420,17240,12910,405809,1629463,792548,1,0,0,3,2459,5119,4727
2021-05-12,186,0,0,0,0,62,95,27,4541,5597,16052,13096,410350,1645515,798145,1,0,0,3,2521,5214,4754
2021-05-13,132,0,0,0,0,26,79,23,2867,3849,11780,13228,413217,1657295,801994,1,0,0,3,2547,5293,4777
2021-05-14,199,0,0,0,0,40,101,45,3639,4150,14573,13427,416856,1671868,806144,1,0,0,3,2587,5394,4822
2021-05-15,213,0,0,0,0,110,80,9,7409,26770,30432,13640,424265,1702300,832914,1,0,0,3,2697,5474,4831
2021-05-16,3,0,0,0,0,0,3,0,1017,651,4533,13643,425282,1706833,833565,1,0,0,3,2697,5477,4831
2021-05-17,184,0,0,0,0,24,116,35,4126,6134,14354,13827,429408,1721187,839699,1,0,0,3,2721,5593,4866
2021-05-18,181,0,0,0,0,34,106,41,5326,5971,20035,14008,434734,1741222,845670,1,0,0,3,2755,5699,4907
2021-05-19,154,0,0,0,0,56,66,24,4803,5965,17674,14162,439537,1758896,851635,1,0,0,3,2811,5765,4931
2021-05-20,266,0,0,0,0,53,163,41,5125,7699,20638,14428,444662,1779534,859334,1,0,0,3,2864,5928,4972
2021-05-21,189,0,0,0,0,39,80,56,5416,6984,20328,14617,450078,1799862,866318,1,0,0,3,2903,6008,5028
2021-05-22,115,0,0,0,0,62,26,16,7185,22231,28010,14732,457263,1827872,888549,1,0,0,3,2965,6034,5044
2021-05-23,13,0,0,0,0,0,8,5,823,397,3722,14745,458086,1831594,888946,1,0,0,3,2965,6042,5049
2021-05-24,57,0,0,0,0,8,26,20,2598,3663,10380,14802,460684,1841974,892609,1,0,0,3,2973,6068,5069
2021-05-25,159,0,0,0,0,36,73,39,4193,9053,17969,14961,464877,1859943,901662,1,0,0,3,3009,6141,5108
2021-05-26,322,0,0,0,0,69,150,95,6225,7558,23251,15283,471102,1883194,909220,1,0,0,3,3078,6291,5203
2021-05-27,417,0,0,0,0,101,245,67,5180,7902,19211,15700,476282,1902405,917122,1,0,0,3,3179,6536,5270
2021-05-28,194,2,0,0,0,47,98,42,5055,8343,19494,15894,481337,1921899,925465,3,0,0,3,3226,6634,5312
2021-05-29,129,0,0,0,0,39,48,35,6491,20171,24982,16023,487828,1946881,945636,3,0,0,3,3265,6682,5347
2021-05-30,10,0,0,0,0,10,0,0,691,233,3164,16033,488519,1950045,945869,3,0,0,3,3275,6682,5347
2021-05-31,152,0,0,0,0,53,58,36,5016,6543,19645,16185,493535,1969690,952412,3,0,0,3,3328,6740,5383
2021-06-01,229,0,0,0,0,73,58,74,4814,6384,18619,16414,498349,1988309,958796,3,0,0,3,3401,6798,5457
2021-06-02,285,0,0,0,0,91,83,99,5523,7022,21192,16699,503872,2009501,965818,3,0,0,3,3492,6881,5556
2021-06-03,97,0,0,0,0,16,71,8,4033,5480,15558,16796,507905,2025059,971298,3,0,0,3,3508,6952,5564
2021-06-04,320,0,0,0,0,114,122,65,10395,26870,40193,17116,518300,2065252,998168,3,0,0,3,3622,7074,5629
2021-06-05,95,0,0,0,0,47,30,15,5363,14745,19702,17211,523663,2084954,1012913,3,0,0,3,3669,7104,5644
2021-06-06,6,0,0,0,0,3,3,0,646,332,2911,17217,524309,2087865,1013245,3,0,0,3,3672,7107,5644
2021-06-07,177,0,0,0,0,45,120,12,5108,5820,19080,17394,529417,2106945,1019065,3,0,0,3,3717,7227,5656
2021-06-08,327,0,0,0,0,122,133,70,5664,7562,20297,17721,535081,2127242,1026627,3,0,0,3,3839,7360,5726
2021-06-09,222,0,2,0,0,60,133,24,5280,7728,19646,17943,540361,2146888,1034355,3,2,0,3,3899,7493,5750
2021-06-10,247,0,0,0,0,99,109,35,4958,6269,18355,18190,545319,2165243,1040624,3,2,0,3,3998,7602,5785
2021-06-11,108,0,0,0,0,29,57,19,5284,6182,20518,18298,550603,2185761,1046806,3,2,0,3,4027,7659,5804
2021-06-12,149,0,0,0,0,53,72,11,4907,13128,17478,18447,555510,2203239,1059934,3,2,0,3,4080,7731,5815
2021-06-13,7,0,0,0,0,3,2,0,1089,1053,4687,18454,556599,2207926,1060987,3,2,0,3,4083,7733,5815
2021-06-14,138,5,0,0,0,68,50,12,4988,6059,18915,18592,561587,2226841,1067046,8,2,0,3,4151,7783,5827
2021-06-15,149,0,0,0,0,53,41,51,4825,5039,17809,18741,566412,2244650,1072085,8,2,0,3,4204,7824,5878
2021-06-16,140,0,0,0,0,66,47,21,4761,4923,16911,18881,571173,2261561,1077008,8,2,0,3,4270,7871,5899
2021-06-17,144,0,0,0,0,33,89,17,4408,5814,15942,19025,575581,2277503,1082822,8,2,0,3,4303,7960,5916
2021-06-18,162,0,0,0,0,53,78,22,5181,6523,18774,19187,580762,2296277,1089345,8,2,0,3,4356,8038,5938
2021-06-19,144,0,0,0,0,23,74,22,4323,11865,16360,19331,585085,2312637,1101210,8,2,0,3,4379,8112,5960
2021-06-20,21,0,0,0,0,6,13,2,895,607,3980,19352,585980,2316617,1101817,8,2,0,3,4385,8125,5962
2021-06-21,218,0,0,0,0,53,106,51,5317,9305,19515,19570,591297,2336132,1111122,8,2,0,3,4438,8231,6013
2021-06-22,168,0,0,0,0,27,89,33,4939,7843,18100,19738,596236,2354232,1118965,8,2,0,3,4465,8320,6046
2021-06-23,164,0,0,0,0,44,64,47,4360,6909,16044,19902,600596,2370276,1125874,8,2,0,3,4509,8384,6093
2021-06-24,236,0,0,0,1,97,76,33,6030,9260,23587,20138,606626,2393863,1135134,8,2,0,4,4606,8460,6126
2021-06-25,228,0,0,0,0,76,97,46,5336,8221,19608,20366,611962,2413471,1143355,8,2,0,4,4682,8557,6172
2021-06-26,157,0,0,0,0,36,75,37,5912,15957,19065,20523,617874,2432536,1159312,8,2,0,4,4718,8632,6209
2021-06-27,34,0,0,0,0,23,11,0,982,961,4210,20557,618856,2436746,1160273,8,2,0,4,4741,8643,6209
2021-06-28,240,0,0,0,0,94,93,37,5627,10435,21516,20797,624483,2458262,1170708,8,2,0,4,4835,8736,6246
2021-06-29,226,0,0,0,0,83,81,56,5053,7570,18567,21023,629536,2476829,1178278,8,2,0,4,4918,8817,6302
2021-06-30,201,2,2,0,0,54,91,50,5813,7628,20865,21224,635349,2497694,1185906,10,4,0,4,4972,8908,6352
2021-07-01,267,0,0,0,0,62,132,43,6379,6869,22827,21491,641728,2520521,1192775,10,4,0,4,5034,9040,6395
2021-07-02,229,0,0,0,0,80,100,48,5437,6930,20290,21720,647165,2540811,1199705,10,4,0,4,5114,9140,6443
2021-07-03,96,0,0,0,0,61,12,11,4095,11123,13887,21816,651260,2554698,1210828,10,4,0,4,5175,9152,6454
2021-07-04,31,0,0,0,0,7,24,0,727,335,3248,21847,651987,2557946,1211163,10,4,0,4,5182,9176,6454
2021-07-05,96,0,0,0,0,33,37,26,7021,7790,26834,21943,659008,2584780,1218953,10,4,0,4,5215,9213,6480
2021-07-06,148,0,0,0,0,40,69,35,5049,7747,19424,22091,664057,2604204,1226700,10,4,0,4,5255,9282,6515
2021-07-07,144,0,0,0,0,47,61,27,5239,7278,19611,22235,669296,2623815,1233978,10,4,0,4,5302,9343,6542
2021-07-08,237,0,0,0,3,62,125,38,5386,8750,20414,22472,674682,2644229,1242728,10,4,0,7,5364,9468,6580
2021-07-09,207,2,0,0,1,73,94,29,5115,9756,20161,22679,679797,2664390,1252484,12,4,0,8,5437,9562,6609
2021-07-10,71,0,0,0,0,25,33,10,3761,8803,14942,22750,683558,2679332,1261287,12,4,0,8,5462,9595,6619
2021-07-11,0,0,0,0,0,0,0,0,698,182,2998,22750,684256,2682330,1261469,12,4,0,8,5462,9595,6619
2021-07-12,264,3,0,0,0,77,147,32,5224,9001,19176,23014,689480,2701506,1270470,15,4,0,8,5539,9742,6651
2021-07-13,255,0,0,0,0,64,151,35,4681,7766,18078,23269,694161,2719584,1278236,15,4,0,8,5603,9893,6686
2021-07-14,141,0,0,0,0,27,82,27,4002,6818,16062,23410,698163,2735646,1285054,15,4,0,8,5630,9975,6713
2021-07-15,200,0,0,0,0,24,107,53,4461,9074,17893,23610,702624,2753539,1294128,15,4,0,8,5654,10082,6766
2021-07-16,350,0,0,0,0,74,172,96,3922,7433,15761,23960,706546,2769300,1301561,15,4,0,8,5728,10254,6862
2021-07-17,168,0,0,0,0,85,66,12,3420,8835,13300,24128,709966,2782600,1310396,15,4,0,8,5813,10320,6874
2021-07-18,0,0,0,0,0,0,0,0,462,189,2001,24128,710428,2784601,1310585,15,4,0,8,5813,10320,6874
2021-07-19,322,0,0,0,0,96,118,84,4133,6494,15348,24450,714561,2799949,1317079,15,4,0,8,5909,10438,6958
2021-07-20,230,0,0,0,0,77,93,59,7356,9070,24040,24680,721917,2823989,1326149,15,4,0,8,5986,10531,7017
2021-07-21,136,0,0,0,0,52,70,11,4466,7774,16677,24816,726383,2840666,1333923,15,4,0,8,6038,10601,7028
2021-07-22,278,0,0,0,0,66,119,86,4501,8987,18679,25094,730884,2859345,1342910,15,4,0,8,6104,10720,7114
2021-07-23,175,0,0,0,0,89,49,33,4050,8204,15000,25269,734934,2874345,1351114,15,4,0,8,6193,10769,7147
2021-07-24,141,0,0,0,0,47,60,16,2075,6870,7267,25410,737009,2881612,1357984,15,4,0,8,6240,10829,7163
2021-07-25,12,0,0,0,0,0,12,0,1500,762,7263,25422,738509,2888875,1358746,15,4,0,8,6240,10841,7163
2021-07-26,126,0,0,0,0,44,37,38,3859,7756,14615,25548,742368,2903490,1366502,15,4,0,8,6284,10878,7201
2021-07-27,119,0,0,0,0,33,59,18,3938,7171,14617,25667,746306,2918107,1373673,15,4,0,8,6317,10937,7219
2021-07-28,320,0,0,0,0,98,144,51,12205,15597,45039,25987,758511,2963146,1389270,15,4,0,8,6415,11081,7270
2021-07-29,256,0,0,0,1,80,108,49,4657,10086,17054,26243,763168,2980200,1399356,15,4,0,9,6495,11189,7319
2021-07-30,150,0,0,0,0,43,75,32,4377,8449,16150,26393,767545,2996350,1407805,15,4,0,9,6538,11264,7351
2021-07-31,171,0,0,0,0,68,68,33,1787,5789,6373,26564,769332,3002723,1413594,15,4,0,9,6606,11332,7384
2021-08-01,0,0,0,0,0,0,0,0,354,210,1627,26564,769686,3004350,1413804,15,4,0,9,6606,11332,7384
2021-08-02,226,0,0,0,0,52,99,64,4545,8127,16841,26790,774231,3021191,1421931,15,4,0,9,6658,11431,7448
2021-08-03,284,0,0,0,0,24,133,117,4727,8265,17075,27074,778958,3038266,1430196,15,4,0,9,6682,11564,7565
2021-08-04,203,0,0,0,0,53,93,50,4640,7326,16855,27277,783598,3055121,1437522,15,4,0,9,6735,11657,7615
2021-08-05,298,0,0,0,0,45,158,88,4388,7486,15925,27575,787986,3071046,1445008,15,4,0,9,6780,11815,7703
2021-08-06,278,0,0,0,0,56,153,46,4216,7282,15381,27853,792202,3086427,1452290,15,4,0,9,6836,11968,7749
2021-08-07,103,0,0,0,0,32,42,11,1733,5466,6274,27956,793935,3092701,1457756,15,4,0,9,6868,12010,7760
2021-08-08,10,0,0,0,0,3,7,0,425,283,1820,27966,794360,3094521,1458039,15,4,0,9,6871,12017,7760
2021-08-09,218,2,0,0,0,77,103,30,4120,6503,14777,28184,798480,3109298,1464542,17,4,0,9,6948,12120,7790
2021-08-10,124,0,0,0,0,92,16,11,4952,6859,17009,28308,803432,3126307,1471401,17,4,0,9,7040,12136,7801
2021-08-11,112,0,0,0,0,43,46,17,4756,6439,16744,28420,808188,3143051,1477840,17,4,0,9,7083,12182,7818
2021-08-12,274,0,0,0,1,85,147,38,5092,7612,17545,28694,813280,3160596,1485452,17,4,0,10,7168,12329,7856
2021-08-13,280,0,0,0,0,106,123,45,4832,8336,17165,28974,818112,3177761,1493788,17,4,0,10,7274,12452,7901
2021-08-14,118,0,0,0,0,38,48,29,1638,4840,5836,29092,819750,3183597,1498628,17,4,0,10,7312,12500,7930
2021-08-15,0,0,0,0,0,0,0,0,469,224,1792,29092,820219,3185389,1498852,17,4,0,10,7312,12500,7930
2021-08-16,269,0,0,0,0,94,110,40,4292,7194,15542,29361,824511,3200931,1506046,17,4,0,10,7406,12610,7970
2021-08-17,327,0,0,0,0,162,108,51,4928,7666,17734,29688,829439,3218665,1513712,17,4,0,10,7568,12718,8021
2021-08-18,281,0,0,0,0,69,132,69,5025,8295,17551,29969,834464,3236216,1522007,17,4,0,10,7637,12850,8090
2021-08-19,258,0,0,0,1,91,82,76,5043,10411,18265,30227,839507,3254481,1532418,17,4,0,11,7728,12932,8166
2021-08-20,265,3,0,0,7,99,109,37,4201,8045,15463,30492,843708,3269944,1540463,20,4,0,18,7827,13041,8203
2021-08-21,94,0,0,0,0,52,40,0,1294,3146,4625,30586,845002,3274569,1543609,20,4,0,18,7879,13081,8203
2021-08-22,3,0,0,0,0,0,3,0,509,286,2320,30589,845511,3276889,1543895,20,4,0,18,7879,13084,8203
2021-08-23,107,0,0,0,0,33,53,15,4717,7499,16369,30696,850228,3293258,1551394,20,4,0,18,7912,13137,8218
2021-08-24,305,0,0,0,0,118,134,47,5856,9933,21335,31001,856084,3314593,1561327,20,4,0,18,8030,13271,8265
2021-08-25,366,4,0,0,2,81,178,93,5320,11215,19515,31367,861404,3334108,1572542,24,4,0,20,8111,13449,8358
2021-08-26,264,0,9,0,0,70,101,75,5130,9398,18328,31631,866534,3352436,1581940,24,13,0,20,8181,13550,8433
2021-08-27,264,0,0,0,3,77,117,59,4742,8793,16180,31895,871276,3368616,1590733,24,13,0,23,8258,13667,8492
2021-08-28,41,0,0,0,0,15,20,6,845,1186,2798,31936,872121,3371414,1591919,24,13,0,23,8273,13687,8498
2021-08-29,5,0,0,0,0,1,4,0,570,564,2246,31941,872691,3373660,1592483,24,13,0,23,8274,13691,8498
2021-08-30,376,0,0,0,0,127,177,58,4586,8092,15760,32317,877277,3389420,1600575,24,13,0,23,8401,13868,8556
2021-08-31,193,0,0,0,0,58,92,39,4804,8611,17214,32510,882081,3406634,1609186,24,13,0,23,8459,13960,8595
2021-09-01,418,0,0,0,1,157,169,84,5887,12949,22372,32928,887968,3429006,1622135,24,13,0,24,8616,14129,8679
2021-09-02,181,0,0,0,1,68,75,24,6769,13235,25348,33109,894737,3454354,1635370,24,13,0,25,8684,14204,8703
2021-09-03,196,0,0,0,0,85,72,28,4454,6377,17111,33305,899191,3471465,1641747,24,13,0,25,8769,14276,8731