date,deaths,death_0_1_month,death_2_month_2_years,death_3_11_years,death_12_17_years,death_18_64_years,death_65_85_years,death_more_than_85_years,reported,severe,injuries,death_3_12_years,total_deaths,total_reported,total_injuries,total_severe,total_death_0_1_month,total_death_2_month_2_years,total_death_3_11_years,total_death_12_17_years,total_death_18_64_years,total_death_65_85_years,total_death_more_than_85_years
2021-01-11,0,0,0,0,0,0,0,0,6,7,26,0,0,6,26,7,0,0,0,0,0,0,0
2021-01-12,0,0,0,0,0,0,0,0,1,2,9,,0,7,35,9,0,0,0,0,0,0,0
2021-01-13,0,0,0,0,0,0,0,0,6,8,14,0,0,13,49,17,0,0,0,0,0,0,0
2021-01-14,0,0,0,0,0,0,0,0,8,12,35,0,0,21,84,29,0,0,0,0,0,0,0
2021-01-15,0,0,0,0,0,0,0,0,5,16,25,0,0,26,109,45,0,0,0,0,0,0,0
2021-01-17,0,0,0,0,0,0,0,0,1,0,6,,0,27,115,45,0,0,0,0,0,0,0
2021-01-18,0,0,0,0,0,0,0,0,5,5,31,0,0,32,146,50,0,0,0,0,0,0,0
2021-01-19,0,0,0,0,0,0,0,0,16,18,50,0,0,48,196,68,0,0,0,0,0,0,0
2021-01-20,0,0,0,0,0,0,0,0,6,6,27,0,0,54,223,74,0,0,0,0,0,0,0
2021-01-21,0,0,0,0,0,0,0,0,28,22,100,0,0,82,323,96,0,0,0,0,0,0,0
2021-01-22,0,0,0,0,0,0,0,0,49,23,177,0,0,131,500,119,0,0,0,0,0,0,0
2021-01-23,1,0,0,0,0,0,0,1,21,17,87,0,1,152,587,136,0,0,0,0,0,0,1
2021-01-24,1,0,0,0,0,0,1,0,3,10,13,0,2,155,600,146,0,0,0,0,0,1,1
2021-01-25,0,0,0,0,0,0,0,0,18,20,63,0,2,173,663,166,0,0,0,0,0,1,1
2021-01-26,0,0,0,0,0,0,0,0,50,45,166,0,2,223,829,211,0,0,0,0,0,1,1
2021-01-27,0,0,0,0,0,0,0,0,57,23,182,0,2,280,1011,234,0,0,0,0,0,1,1
2021-01-28,2,0,0,0,0,0,0,2,63,30,204,0,4,343,1215,264,0,0,0,0,0,1,3
2021-01-29,1,0,0,0,0,0,0,1,65,57,192,0,5,408,1407,321,0,0,0,0,0,1,4
2021-01-30,0,0,0,0,0,0,0,0,15,8,50,0,5,423,1457,329,0,0,0,0,0,1,4
2021-01-31,0,0,0,0,0,0,0,0,4,1,8,0,5,427,1465,330,0,0,0,0,0,1,4
2021-02-01,1,0,0,0,0,0,1,0,60,33,204,0,6,487,1669,363,0,0,0,0,0,2,4
2021-02-02,8,0,0,0,0,0,7,1,85,110,383,0,14,572,2052,473,0,0,0,0,0,9,5
2021-02-03,0,0,0,0,0,0,0,0,51,49,190,0,14,623,2242,522,0,0,0,0,0,9,5
2021-02-04,2,0,0,0,0,0,0,2,81,57,318,0,16,704,2560,579,0,0,0,0,0,9,7
2021-02-05,4,0,0,0,0,0,0,3,56,54,233,0,20,760,2793,633,0,0,0,0,0,9,10
2021-02-06,0,0,0,0,0,0,0,0,40,13,180,0,20,800,2973,646,0,0,0,0,0,9,10
2021-02-07,0,0,0,0,0,0,0,0,19,1,78,0,20,819,3051,647,0,0,0,0,0,9,10
2021-02-08,2,0,0,0,0,1,1,0,63,48,270,0,22,882,3321,695,0,0,0,0,1,10,10
2021-02-09,11,0,0,0,0,6,4,1,80,115,332,0,33,962,3653,810,0,0,0,0,7,14,11
2021-02-10,48,0,0,0,0,15,14,17,135,230,437,0,81,1097,4090,1040,0,0,0,0,22,28,28
2021-02-11,73,0,0,0,0,4,27,42,168,727,813,0,154,1265,4903,1767,0,0,0,0,26,55,70
2021-02-12,9,0,0,0,0,0,3,5,135,209,587,0,163,1400,5490,1976,0,0,0,0,26,58,75
2021-02-13,0,0,0,0,0,0,0,0,64,1,205,0,163,1464,5695,1977,0,0,0,0,26,58,75
2021-02-14,0,0,0,0,0,0,0,0,24,25,122,0,163,1488,5817,2002,0,0,0,0,26,58,75
2021-02-15,9,0,0,0,0,5,0,4,78,203,362,0,172,1566,6179,2205,0,0,0,0,31,58,79
2021-02-16,91,0,0,0,0,17,51,23,220,609,869,0,263,1786,7048,2814,0,0,0,0,48,109,102
2021-02-17,27,0,0,0,0,0,17,9,153,396,704,0,290,1939,7752,3210,0,0,0,0,48,126,111
2021-02-18,17,0,0,0,0,11,5,0,106,127,403,0,307,2045,8155,3337,0,0,0,0,59,131,111
2021-02-19,10,0,0,0,0,0,0,10,151,169,579,0,317,2196,8734,3506,0,0,0,0,59,131,121
2021-02-20,4,0,0,0,0,0,0,4,43,37,167,0,321,2239,8901,3543,0,0,0,0,59,131,125
2021-02-21,0,0,0,0,0,0,0,0,11,3,47,0,321,2250,8948,3546,0,0,0,0,59,131,125
2021-02-22,30,0,0,0,0,2,16,10,112,190,428,0,351,2362,9376,3736,0,0,0,0,61,147,135
2021-02-23,49,0,0,0,0,7,22,20,146,397,551,0,400,2508,9927,4133,0,0,0,0,68,169,155
2021-02-24,124,0,0,0,0,7,79,38,238,700,879,0,524,2746,10806,4833,0,0,0,0,75,248,193
2021-02-25,20,0,0,0,0,0,17,3,117,251,467,0,544,2863,11273,5084,0,0,0,0,75,265,196
2021-02-26,18,0,0,0,0,0,3,15,57,128,271,0,562,2920,11544,5212,0,0,0,0,75,268,211
2021-02-27,5,0,0,0,0,4,1,0,104,87,306,0,567,3024,11850,5299,0,0,0,0,79,269,211
2021-02-28,7,0,0,0,0,0,0,6,68,44,283,0,574,3092,12133,5343,0,0,0,0,79,269,217
2021-03-01,30,0,0,0,0,5,9,16,98,197,403,0,604,3190,12536,5540,0,0,0,0,84,278,233
2021-03-02,80,0,0,0,0,7,48,25,179,454,651,0,684,3369,13187,5994,0,0,0,0,91,326,258
2021-03-03,119,0,0,0,0,26,39,50,238,746,931,0,803,3607,14118,6740,0,0,0,0,117,365,308
2021-03-04,57,0,0,0,0,4,26,27,182,468,676,0,860,3789,14794,7208,0,0,0,0,121,391,335
2021-03-05,72,0,0,0,0,14,36,22,328,559,1512,0,932,4117,16306,7767,0,0,0,0,135,427,357
2021-03-06,0,0,0,0,0,0,0,0,57,20,172,0,932,4174,16478,7787,0,0,0,0,135,427,357
2021-03-07,0,0,0,0,0,0,0,0,7,0,32,0,932,4181,16510,7787,0,0,0,0,135,427,357
2021-03-08,49,0,0,0,0,10,16,23,251,407,949,0,981,4432,17459,8194,0,0,0,0,145,443,380
2021-03-09,75,0,0,0,0,13,37,25,324,781,1165,0,1056,4756,18624,8975,0,0,0,0,158,480,405
2021-03-10,32,0,0,0,0,2,28,1,314,530,1185,0,1088,5070,19809,9505,0,0,0,0,160,508,406
2021-03-11,48,0,0,0,0,22,9,17,210,346,811,0,1136,5280,20620,9851,0,0,0,0,182,517,423
2021-03-12,15,0,0,0,0,0,9,5,201,535,812,0,1151,5481,21432,10386,0,0,0,0,182,526,428
2021-03-13,0,0,0,0,0,0,0,0,46,30,148,0,1151,5527,21580,10416,0,0,0,0,182,526,428
2021-03-14,0,0,0,0,0,0,0,0,13,8,46,0,1151,5540,21626,10424,0,0,0,0,182,526,428
2021-03-15,24,0,0,0,0,1,8,12,157,285,657,0,1175,5697,22283,10709,0,0,0,0,183,534,440
2021-03-16,17,0,0,0,0,1,8,8,170,198,569,0,1192,5867,22852,10907,0,0,0,0,184,542,448
2021-03-17,12,0,0,0,0,2,3,7,214,194,735,0,1204,6081,23587,11101,0,0,0,0,186,545,455
2021-03-18,20,0,0,0,0,1,7,11,169,208,656,0,1224,6250,24243,11309,0,0,0,0,187,552,466
2021-03-19,38,0,0,0,0,14,14,9,206,228,770,0,1262,6456,25013,11537,0,0,0,0,201,566,475
2021-03-20,0,0,0,0,0,0,0,0,177,50,1097,0,1262,6633,26110,11587,0,0,0,0,201,566,475
2021-03-21,0,0,0,0,0,0,0,0,111,0,709,0,1262,6744,26819,11587,0,0,0,0,201,566,475
2021-03-22,39,0,0,0,0,5,20,12,265,375,1249,0,1301,7009,28068,11962,0,0,0,0,206,586,487
2021-03-23,52,0,0,0,0,9,25,17,469,971,2052,0,1353,7478,30120,12933,0,0,0,0,215,611,504
2021-03-24,35,0,0,0,0,6,21,8,427,576,1851,0,1388,7905,31971,13509,0,0,0,0,221,632,512
2021-03-25,40,0,0,0,0,2,22,16,639,359,3328,0,1428,8544,35299,13868,0,0,0,0,223,654,528
2021-03-26,28,0,0,0,0,2,14,12,249,273,1285,0,1456,8793,36584,14141,0,0,0,0,225,668,540
2021-03-27,1,0,0,0,0,0,1,0,55,28,175,0,1457,8848,36759,14169,0,0,0,0,225,669,540
2021-03-28,0,0,0,0,0,0,0,0,124,15,638,0,1457,8972,37397,14184,0,0,0,0,225,669,540
2021-03-29,60,0,0,0,0,1,36,23,481,752,2080,0,1517,9453,39477,14936,0,0,0,0,226,705,563
2021-03-30,40,0,0,0,0,10,14,15,444,769,1867,0,1557,9897,41344,15705,0,0,0,0,236,719,578
2021-03-31,63,0,0,0,0,3,37,22,466,967,1939,0,1620,10363,43283,16672,0,0,0,0,239,756,600
2021-04-01,102,0,0,0,0,23,60,18,339,622,1327,0,1722,10702,44610,17294,0,0,0,0,262,816,618
2021-04-02,57,0,0,0,0,10,27,20,259,453,919,0,1779,10961,45529,17747,0,0,0,0,272,843,638
2021-04-03,0,0,0,0,0,0,0,0,97,42,219,0,1779,11058,45748,17789,0,0,0,0,272,843,638
2021-04-04,0,0,0,0,0,0,0,0,12,3,44,0,1779,11070,45792,17792,0,0,0,0,272,843,638
2021-04-05,67,0,0,0,0,12,31,24,319,858,1638,0,1846,11389,47430,18650,0,0,0,0,284,874,662
2021-04-06,117,0,0,0,0,36,52,27,406,726,1618,0,1963,11795,49048,19376,0,0,0,0,320,926,689
2021-04-07,58,0,0,0,0,8,29,21,424,594,1794,0,2021,12219,50842,19970,0,0,0,0,328,955,710
2021-04-08,134,0,0,0,0,6,102,26,382,761,1646,0,2155,12601,52488,20731,0,0,0,0,334,1057,736
2021-04-09,68,0,0,0,0,3,25,40,370,848,1618,0,2223,12971,54106,21579,0,0,0,0,337,1082,776
2021-04-10,2,0,0,0,0,1,0,1,76,28,276,0,2225,13047,54382,21607,0,0,0,0,338,1082,777
2021-04-11,1,0,0,0,0,0,0,1,21,1,141,0,2226,13068,54523,21608,0,0,0,0,338,1082,778
2021-04-12,8,0,0,0,0,1,6,1,172,148,540,0,2234,13240,55063,21756,0,0,0,0,339,1088,779
2021-04-13,90,0,0,0,0,8,49,21,596,1134,2447,0,2324,13836,57510,22890,0,0,0,0,347,1137,800
2021-04-14,52,0,0,0,0,11,18,23,391,596,1656,0,2376,14227,59166,23486,0,0,0,0,358,1155,823
2021-04-15,32,0,0,0,0,6,17,8,336,581,1379,0,2408,14563,60545,24067,0,0,0,0,364,1172,831
2021-04-16,26,0,0,0,0,0,20,6,317,372,1381,0,2434,14880,61926,24439,0,0,0,0,364,1192,837
2021-04-17,1,0,0,0,0,0,0,1,116,20,608,0,2435,14996,62534,24459,0,0,0,0,364,1192,838
2021-04-18,0,0,0,0,0,0,0,0,44,6,238,0,2435,15040,62772,24465,0,0,0,0,364,1192,838
2021-04-19,32,0,0,0,0,13,8,10,340,407,1282,0,2467,15380,64054,24872,0,0,0,0,377,1200,848
2021-04-20,28,0,0,0,0,6,8,11,621,589,2900,0,2495,16001,66954,25461,0,0,0,0,383,1208,859
2021-04-21,47,0,0,0,0,10,23,13,396,451,1414,0,2542,16397,68368,25912,0,0,0,0,393,1231,872
2021-04-22,132,0,0,0,0,23,81,28,361,483,1324,0,2674,16758,69692,26395,0,0,0,0,416,1312,900
2021-04-23,80,0,0,0,0,14,57,9,276,363,1093,0,2754,17034,70785,26758,0,0,0,0,430,1369,909
2021-04-24,3,0,0,0,0,0,0,3,111,82,549,0,2757,17145,71334,26840,0,0,0,0,430,1369,912
2021-04-25,1,0,0,0,0,0,1,0,80,19,455,0,2758,17225,71789,26859,0,0,0,0,430,1370,912
2021-04-26,58,0,0,0,0,4,10,43,381,517,1617,0,2816,17606,73406,27376,0,0,0,0,434,1380,955
2021-04-27,4,0,0,0,0,0,1,3,419,506,1768,0,2820,18025,75174,27882,0,0,0,0,434,1381,958
2021-04-28,45,0,0,0,0,11,27,7,349,410,1254,0,2865,18374,76428,28292,0,0,0,0,445,1408,965
2021-04-29,101,0,0,0,0,23,43,35,396,573,1426,0,2966,18770,77854,28865,0,0,0,0,468,1451,1000
2021-04-30,101,0,0,0,1,15,47,38,397,625,1483,0,3067,19167,79337,29490,0,0,0,1,483,1498,1038
2021-05-01,7,0,0,0,0,1,1,5,136,36,501,0,3074,19303,79838,29526,0,0,0,1,484,1499,1043
2021-05-02,0,0,0,0,0,0,0,0,104,2,611,0,3074,19407,80449,29528,0,0,0,1,484,1499,1043
2021-05-03,184,0,0,0,0,54,105,24,459,904,1629,0,3258,19866,82078,30432,0,0,0,1,538,1604,1067
2021-05-04,24,0,0,0,0,4,15,4,481,798,1787,0,3282,20347,83865,31230,0,0,0,1,542,1619,1071
2021-05-05,29,0,0,0,0,1,13,15,629,1227,2658,0,3311,20976,86523,32457,0,0,0,1,543,1632,1086
2021-05-06,24,0,0,0,0,4,11,8,551,875,2106,0,3335,21527,88629,33332,0,0,0,1,547,1643,1094
2021-05-07,53,0,0,0,0,27,18,8,459,678,1929,0,3388,21986,90558,34010,0,0,0,1,574,1661,1102
2021-05-08,9,0,0,0,0,0,7,2,193,76,965,0,3397,22179,91523,34086,0,0,0,1,574,1668,1104
2021-05-09,0,0,0,0,0,0,0,0,100,0,571,0,3397,22279,92094,34086,0,0,0,1,574,1668,1104
2021-05-10,90,0,0,0,0,27,46,17,606,674,2290,0,3487,22885,94384,34760,0,0,0,1,601,1714,1121
2021-05-11,104,0,0,0,0,19,53,32,619,948,2309,0,3591,23504,96693,35708,0,0,0,1,620,1767,1153
2021-05-12,35,0,0,0,0,7,25,3,485,637,1928,0,3626,23989,98621,36345,0,0,0,1,627,1792,1156
2021-05-13,61,0,0,0,0,11,41,8,421,629,1937,0,3687,24410,100558,36974,0,0,0,1,638,1833,1164
2021-05-14,36,0,0,0,0,7,18,9,397,502,1465,0,3723,24807,102023,37476,0,0,0,1,645,1851,1173
2021-05-15,6,0,0,0,0,5,0,1,133,38,642,0,3729,24940,102665,37514,0,0,0,1,650,1851,1174
2021-05-16,0,0,0,0,0,0,0,0,128,23,707,0,3729,25068,103372,37537,0,0,0,1,650,1851,1174
2021-05-17,23,0,0,0,0,1,20,2,570,927,2054,0,3752,25638,105426,38464,0,0,0,1,651,1871,1176
2021-05-18,32,0,0,0,0,1,18,13,651,739,2675,0,3784,26289,108101,39203,0,0,0,1,652,1889,1189
2021-05-19,47,0,0,0,0,15,26,6,628,1072,2533,0,3831,26917,110634,40275,0,0,0,1,667,1915,1195
2021-05-20,95,0,0,0,0,27,49,18,851,1362,3250,0,3926,27768,113884,41637,0,0,0,1,694,1964,1213
2021-05-21,52,0,0,0,0,11,27,14,1035,1808,4408,0,3978,28803,118292,43445,0,0,0,1,705,1991,1227
2021-05-22,2,0,0,0,0,0,2,0,385,626,2115,0,3980,29188,120407,44071,0,0,0,1,705,1993,1227
2021-05-23,0,0,0,0,0,0,0,0,152,61,795,0,3980,29340,121202,44132,0,0,0,1,705,1993,1227
2021-05-24,13,0,0,0,0,0,11,1,412,573,1819,0,3993,29752,123021,44705,0,0,0,1,705,2004,1228
2021-05-25,18,0,0,0,0,5,11,1,1244,4737,5959,0,4011,30996,128980,49442,0,0,0,1,710,2015,1229
2021-05-26,119,0,0,0,0,32,57,27,1320,2421,5912,0,4130,32316,134892,51863,0,0,0,1,742,2072,1256
2021-05-27,249,0,0,0,0,59,160,30,1107,2138,4608,0,4379,33423,139500,54001,0,0,0,1,801,2232,1286
2021-05-28,26,0,0,0,0,3,10,10,1020,1654,4561,0,4405,34443,144061,55655,0,0,0,1,804,2242,1296
2021-05-29,4,0,0,0,0,0,1,3,237,126,1082,0,4409,34680,145143,55781,0,0,0,1,804,2243,1299
2021-05-30,0,0,0,0,0,0,0,0,86,67,535,0,4409,34766,145678,55848,0,0,0,1,804,2243,1299
2021-05-31,11,0,0,0,0,4,4,2,994,1211,4324,0,4420,35760,150002,57059,0,0,0,1,808,2247,1301
2021-06-01,53,0,0,0,0,21,15,14,786,1189,3350,0,4473,36546,153352,58248,0,0,0,1,829,2262,1315
2021-06-02,129,0,0,0,0,60,50,18,1156,2357,4545,0,4602,37702,157897,60605,0,0,0,1,889,2312,1333
2021-06-03,28,0,0,0,0,4,24,0,920,1116,3955,0,4630,38622,161852,61721,0,0,0,1,893,2336,1333
2021-06-04,18,0,0,0,0,4,11,2,701,854,3081,0,4648,39323,164933,62575,0,0,0,1,897,2347,1335
2021-06-05,1,0,0,0,0,0,1,0,272,174,1359,0,4649,39595,166292,62749,0,0,0,1,897,2348,1335
2021-06-06,1,0,0,0,0,1,0,0,126,66,660,0,4650,39721,166952,62815,0,0,0,1,898,2348,1335
2021-06-07,29,0,0,0,0,9,17,3,779,1126,3141,0,4679,40500,170093,63941,0,0,0,1,907,2365,1338
2021-06-08,147,0,0,0,0,40,80,27,999,2071,3674,0,4826,41499,173767,66012,0,0,0,1,947,2445,1365
2021-06-09,92,0,0,0,0,11,78,3,873,1888,3433,0,4918,42372,177200,67900,0,0,0,1,958,2523,1368
2021-06-10,38,0,0,0,0,12,17,9,1024,2327,4144,0,4956,43396,181344,70227,0,0,0,1,970,2540,1377
2021-06-11,31,0,0,0,0,7,18,6,978,1474,4464,0,4987,44374,185808,71701,0,0,0,1,977,2558,1383
2021-06-12,6,0,0,0,0,0,6,0,369,375,1737,0,4993,44743,187545,72076,0,0,0,1,977,2564,1383
2021-06-13,0,0,0,0,0,0,0,0,130,9,750,0,4993,44873,188295,72085,0,0,0,1,977,2564,1383
2021-06-14,21,5,0,0,0,4,8,3,707,1009,3114,0,5014,45580,191409,73094,5,0,0,1,981,2572,1386
2021-06-15,13,0,0,0,0,8,4,1,708,639,2879,0,5027,46288,194288,73733,5,0,0,1,989,2576,1387
2021-06-16,34,0,0,0,0,13,15,3,867,1074,3460,0,5061,47155,197748,74807,5,0,0,1,1002,2591,1390
2021-06-17,22,0,0,0,0,2,16,4,838,1154,3436,0,5083,47993,201184,75961,5,0,0,1,1004,2607,1394
2021-06-18,28,0,0,0,0,4,20,4,1034,1917,4501,0,5111,49027,205685,77878,5,0,0,1,1008,2627,1398
2021-06-19,7,0,0,0,0,1,2,4,346,317,1867,0,5118,49373,207552,78195,5,0,0,1,1009,2629,1402
2021-06-20,17,0,0,0,0,6,11,0,213,240,1186,0,5135,49586,208738,78435,5,0,0,1,1015,2640,1402
2021-06-21,108,0,0,0,0,37,53,17,1157,3714,4987,0,5243,50743,213725,82149,5,0,0,1,1052,2693,1419
2021-06-22,14,0,0,0,0,0,10,3,964,1961,4000,0,5257,51707,217725,84110,5,0,0,1,1052,2703,1422
2021-06-23,36,0,0,0,0,8,13,13,892,2110,3848,0,5293,52599,221573,86220,5,0,0,1,1060,2716,1435
2021-06-24,34,0,0,0,0,26,7,1,1112,1844,4447,0,5327,53711,226020,88064,5,0,0,1,1086,2723,1436
2021-06-25,33,0,0,0,0,8,17,3,1128,2209,4572,0,5360,54839,230592,90273,5,0,0,1,1094,2740,1439
2021-06-26,18,0,0,0,0,13,0,5,487,1303,2126,0,5378,55326,232718,91576,5,0,0,1,1107,2740,1444
2021-06-27,10,0,0,0,0,3,7,0,143,110,745,0,5388,55469,233463,91686,5,0,0,1,1110,2747,1444
2021-06-28,57,0,0,0,0,34,17,5,1245,3414,5407,0,5445,56714,238870,95100,5,0,0,1,1144,2764,1449
2021-06-29,69,0,0,0,0,35,31,3,998,2226,4384,0,5514,57712,243254,97326,5,0,0,1,1179,2795,1452
2021-06-30,30,0,0,0,0,10,16,4,1019,1558,4218,0,5544,58731,247472,98884,5,0,0,1,1189,2811,1456
2021-07-01,42,0,0,0,0,6,24,12,1236,2054,5109,0,5586,59967,252581,100938,5,0,0,1,1195,2835,1468
2021-07-02,78,0,0,0,0,18,40,20,1342,2631,5729,0,5664,61309,258310,103569,5,0,0,1,1213,2875,1488
2021-07-03,0,0,0,0,0,0,0,0,221,251,1030,0,5664,61530,259340,103820,5,0,0,1,1213,2875,1488
2021-07-04,0,0,0,0,0,0,0,0,130,31,798,0,5664,61660,260138,103851,5,0,0,1,1213,2875,1488
2021-07-05,9,0,0,0,0,4,5,0,1262,1085,5744,0,5673,62922,265882,104936,5,0,0,1,1217,2880,1488
2021-07-06,41,0,0,0,0,5,19,16,976,1964,4489,0,5714,63898,270371,106900,5,0,0,1,1222,2899,1504
2021-07-07,37,0,0,0,0,13,19,3,1308,2259,5714,0,5751,65206,276085,109159,5,0,0,1,1235,2918,1507
2021-07-08,120,0,0,0,0,8,82,28,1122,2798,5070,0,5871,66328,281155,111957,5,0,0,1,1243,3000,1535
2021-07-09,18,0,0,0,1,3,10,1,868,1403,3905,0,5889,67196,285060,113360,5,0,0,2,1246,3010,1536
2021-07-10,3,0,0,0,0,0,2,1,311,64,1894,0,5892,67507,286954,113424,5,0,0,2,1246,3012,1537
2021-07-11,0,0,0,0,0,0,0,0,170,27,982,0,5892,67677,287936,113451,5,0,0,2,1246,3012,1537
2021-07-12,126,0,0,0,0,49,58,19,1273,2328,5005,0,6018,68950,292941,115779,5,0,0,2,1295,3070,1556
2021-07-13,157,0,0,0,0,45,87,24,1383,2963,6275,0,6175,70333,299216,118742,5,0,0,2,1340,3157,1580
2021-07-14,41,0,0,0,0,1,35,5,1012,1825,4789,0,6216,71345,304005,120567,5,0,0,2,1341,3192,1585
2021-07-15,57,0,0,0,0,9,38,8,1101,2588,5271,0,6273,72446,309276,123155,5,0,0,2,1350,3230,1593
2021-07-16,150,0,0,0,0,31,64,53,1118,2895,5286,0,6423,73564,314562,126050,5,0,0,2,1381,3294,1646
2021-07-17,2,0,0,0,0,0,2,0,330,81,1881,0,6425,73894,316443,126131,5,0,0,2,1381,3296,1646
2021-07-18,0,0,0,0,0,0,0,0,119,1,716,0,6425,74013,317159,126132,5,0,0,2,1381,3296,1646
2021-07-19,64,0,0,0,0,25,25,14,948,1836,4266,0,6489,74961,321425,127968,5,0,0,2,1406,3321,1660
2021-07-20,31,0,0,0,0,11,12,8,1449,1819,5596,0,6520,76410,327021,129787,5,0,0,2,1417,3333,1668
2021-07-21,57,0,0,0,0,27,25,5,1018,2137,4614,0,6577,77428,331635,131924,5,0,0,2,1444,3358,1673
2021-07-22,127,0,0,0,0,33,61,33,776,2096,3724,0,6704,78204,335359,134020,5,0,0,2,1477,3419,1706
2021-07-23,4,0,0,0,0,0,2,2,727,1356,2843,0,6708,78931,338202,135376,5,0,0,2,1477,3421,1708
2021-07-24,5,0,0,0,0,0,0,5,81,68,316,0,6713,79012,338518,135444,5,0,0,2,1477,3421,1713
2021-07-25,0,0,0,0,0,0,0,0,397,23,2498,0,6713,79409,341016,135467,5,0,0,2,1477,3421,1713
2021-07-26,15,0,0,0,0,13,2,0,638,1112,2707,0,6728,80047,343723,136579,5,0,0,2,1490,3423,1713
2021-07-27,10,0,0,0,0,2,7,1,639,806,2594,0,6738,80686,346317,137385,5,0,0,2,1492,3430,1714
2021-07-28,34,0,0,0,0,23,4,5,1276,1551,4151,0,6772,81962,350468,138936,5,0,0,2,1515,3434,1719
2021-07-29,56,0,0,0,0,26,22,6,756,1654,3109,0,6828,82718,353577,140590,5,0,0,2,1541,3456,1725
2021-07-30,16,0,0,0,0,5,6,5,664,1340,2566,0,6844,83382,356143,141930,5,0,0,2,1546,3462,1730
2021-07-31,2,0,0,0,0,1,0,1,98,140,487,0,6846,83480,356630,142070,5,0,0,2,1547,3462,1731
2021-08-01,0,0,0,0,0,0,0,0,56,9,279,0,6846,83536,356909,142079,5,0,0,2,1547,3462,1731
2021-08-02,56,0,0,0,0,15,22,15,676,1680,2983,0,6902,84212,359892,143759,5,0,0,2,1562,3484,1746
2021-08-03,18,0,0,0,0,3,6,5,740,1294,2927,0,6920,84952,362819,145053,5,0,0,2,1565,3490,1751
2021-08-04,26,0,0,0,0,2,22,2,902,1648,3547,0,6946,85854,366366,146701,5,0,0,2,1567,3512,1753
2021-08-05,64,0,0,0,0,2,56,5,957,2246,3944,0,7010,86811,370310,148947,5,0,0,2,1569,3568,1758
2021-08-06,54,0,0,0,0,10,26,18,498,552,1886,0,7064,87309,372196,149499,5,0,0,2,1579,3594,1776
2021-08-07,8,0,0,0,0,0,8,0,115,65,436,0,7072,87424,372632,149564,5,0,0,2,1579,3602,1776
2021-08-08,0,0,0,0,0,0,0,0,63,24,389,0,7072,87487,373021,149588,5,0,0,2,1579,3602,1776
2021-08-09,28,0,0,0,0,18,9,1,451,426,1766,0,7100,87938,374787,150014,5,0,0,2,1597,3611,1777
2021-08-10,5,0,0,0,0,2,3,0,550,314,1908,0,7105,88488,376695,150328,5,0,0,2,1599,3614,1777
2021-08-11,9,0,0,0,0,3,3,0,623,571,2384,0,7114,89111,379079,150899,5,0,0,2,1602,3617,1777
2021-08-12,14,0,0,0,0,3,9,2,688,636,2407,0,7128,89799,381486,151535,5,0,0,2,1605,3626,1779
2021-08-13,86,0,0,0,0,26,43,15,866,1973,3733,0,7214,90665,385219,153508,5,0,0,2,1631,3669,1794
2021-08-14,52,0,0,0,0,0,29,23,239,813,1148,0,7266,90904,386367,154321,5,0,0,2,1631,3698,1817
2021-08-15,0,0,0,0,0,0,0,0,84,7,424,0,7266,90988,386791,154328,5,0,0,2,1631,3698,1817
2021-08-16,55,0,0,0,0,35,14,5,783,1734,3407,0,7321,91771,390198,156062,5,0,0,2,1666,3712,1822
2021-08-17,89,0,0,0,0,45,32,11,1000,1994,4585,0,7410,92771,394783,158056,5,0,0,2,1711,3744,1833
2021-08-18,83,0,0,0,0,23,43,17,1318,2571,5044,0,7493,94089,399827,160627,5,0,0,2,1734,3787,1850
2021-08-19,66,0,0,0,0,15,26,24,1063,1781,3960,0,7559,95152,403787,162408,5,0,0,2,1749,3813,1874
2021-08-20,43,0,0,0,0,25,11,4,695,1265,2924,0,7602,95847,406711,163673,5,0,0,2,1774,3824,1878
2021-08-21,4,0,0,0,0,0,4,0,233,93,950,0,7606,96080,407661,163766,5,0,0,2,1774,3828,1878
2021-08-22,0,0,0,0,0,0,0,0,106,26,630,0,7606,96186,408291,163792,5,0,0,2,1774,3828,1878
2021-08-23,7,0,0,0,0,4,3,0,932,1531,3774,0,7613,97118,412065,165323,5,0,0,2,1778,3831,1878
2021-08-24,28,0,0,0,0,13,14,1,974,1218,3849,0,7641,98092,415914,166541,5,0,0,2,1791,3845,1879
2021-08-25,146,0,0,0,0,49,78,17,1265,3553,5501,0,7787,99357,421415,170094,5,0,0,2,1840,3923,1896
2021-08-26,49,0,0,0,0,15,15,19,864,1454,3573,0,7836,100221,424988,171548,5,0,0,2,1855,3938,1915
2021-08-27,32,0,0,0,0,22,8,1,946,1529,3586,0,7868,101167,428574,173077,5,0,0,2,1877,3946,1916
2021-08-28,0,0,0,0,0,0,0,0,143,91,512,0,7868,101310,429086,173168,5,0,0,2,1877,3946,1916
2021-08-29,0,0,0,0,0,0,0,0,79,50,369,0,7868,101389,429455,173218,5,0,0,2,1877,3946,1916
2021-08-30,32,0,0,0,0,4,22,4,872,1502,3493,0,7900,102261,432948,174720,5,0,0,2,1881,3968,1920
2021-08-31,27,0,0,0,0,2,24,0,912,1205,3455,0,7927,103173,436403,175925,5,0,0,2,1883,3992,1920
2021-09-01,182,0,0,0,0,49,82,50,1412,4064,6001,0,8109,104585,442404,179989,5,0,0,2,1932,4074,1970
2021-09-02,34,0,0,0,0,6,21,3,1102,2076,4663,0,8143,105687,447067,182065,5,0,0,2,1938,4095,1973
2021-09-03,44,0,0,0,0,12,27,5,926,1336,4066,0,8187,106613,451133,183401,5,0,0,2,1950,4122,1978