date,deaths,injuries,severe,reported,death_0_1_month,death_2_month_2_years,death_3_11_years,death_12_17_years,death_18_64_years,death_65_85_years,death_more_than_85_years,death_years_not_specified,death_3_12_years,total_deaths,total_reported,total_injuries,total_severe,total_death_0_1_month,total_death_2_month_2_years,total_death_3_11_years,total_death_12_17_years,total_death_18_64_years,total_death_65_85_years,total_death_more_than_85_years,total_death_years_not_specified
2021-01-01,0,583,0,155,0,0,0,0,0,0,0,0,0,0,155,583,0,0,0,0,0,0,0,0,0
2021-01-02,0,490,0,145,0,0,0,0,0,0,0,0,0,0,300,1073,0,0,0,0,0,0,0,0,0
2021-01-03,0,475,0,130,0,0,0,0,0,0,0,0,0,0,430,1548,0,0,0,0,0,0,0,0,0
2021-01-04,3,2087,0,608,0,0,0,0,0,2,1,0,0,3,1038,3635,0,0,0,0,0,0,2,1,0
2021-01-05,7,3765,0,1131,0,0,0,0,2,1,4,0,0,10,2169,7400,0,0,0,0,0,2,3,5,0
2021-01-06,2,3616,0,1107,0,0,0,0,1,1,0,0,0,12,3276,11016,0,0,0,0,0,3,4,5,0
2021-01-07,5,3734,0,1067,0,0,0,0,0,4,1,0,0,17,4343,14750,0,0,0,0,0,3,8,6,0
2021-01-08,4,5654,0,1689,0,0,0,0,0,3,0,0,0,21,6032,20404,0,0,0,0,0,3,11,6,0
2021-01-09,1,1856,0,508,0,0,0,0,0,1,0,0,0,22,6540,22260,0,0,0,0,0,3,12,6,0
2021-01-10,4,1916,0,499,0,0,0,0,2,2,0,0,0,26,7039,24176,0,0,0,0,0,5,14,6,0
2021-01-11,10,4475,0,1260,0,0,0,0,3,3,3,0,0,36,8299,28651,0,0,0,0,0,8,17,9,0
2021-01-12,8,5114,0,1491,0,0,0,0,3,1,3,0,0,44,9790,33765,0,0,0,0,0,11,18,12,0
2021-01-13,9,6066,0,1451,0,0,0,0,2,3,4,0,0,53,11241,39831,0,0,0,0,0,13,21,16,0
2021-01-14,13,7100,0,1420,0,0,0,0,3,6,4,0,0,66,12661,46931,0,0,0,0,0,16,27,20,0
2021-01-15,1,1409,0,308,0,0,0,0,0,0,1,0,0,67,12969,48340,0,0,0,0,0,16,27,21,0
2021-01-16,4,1219,0,328,0,0,0,0,0,2,2,0,0,71,13297,49559,0,0,0,0,0,16,29,23,0
2021-01-17,4,1077,0,291,0,0,0,0,0,1,2,0,0,75,13588,50636,0,0,0,0,0,16,30,25,0
2021-01-18,9,2723,0,778,0,0,0,0,0,8,1,0,0,84,14366,53359,0,0,0,0,0,16,38,26,0
2021-01-19,14,4134,0,1245,0,0,0,0,4,5,3,0,0,98,15611,57493,0,0,0,0,0,20,43,29,0
2021-01-20,9,3533,0,988,0,0,0,0,2,4,3,0,0,107,16599,61026,0,0,0,0,0,22,47,32,0
2021-01-21,27,4674,0,1390,0,0,0,0,3,9,8,0,0,134,17989,65700,0,0,0,0,0,25,56,40,0
2021-01-22,13,3696,0,1084,0,0,0,0,3,4,4,0,0,147,19073,69396,0,0,0,0,0,28,60,44,0
2021-01-23,2,1762,0,366,0,0,0,0,2,0,0,0,0,149,19439,71158,0,0,0,0,0,30,60,44,0
2021-01-24,3,1535,0,307,0,0,0,0,0,2,1,0,0,152,19746,72693,0,0,0,0,0,30,62,45,0
2021-01-25,15,5150,0,1030,0,0,0,0,0,5,5,0,0,167,20776,77843,0,0,0,0,0,30,67,50,0
2021-01-26,16,6490,0,1298,0,0,0,0,0,9,7,0,0,183,22074,84333,0,0,0,0,0,30,76,57,0
2021-01-27,14,5495,0,1099,0,0,0,0,2,7,3,0,0,197,23173,89828,0,0,0,0,0,32,83,60,0
2021-01-28,11,3725,0,886,0,0,0,0,4,1,6,0,0,208,24059,93553,0,0,0,0,0,36,84,66,0
2021-01-29,19,3930,0,1206,0,0,0,0,2,8,8,0,0,227,25265,97483,0,0,0,0,0,38,92,74,0
2021-01-30,3,1248,0,358,0,0,0,0,0,3,0,0,0,230,25623,98731,0,0,0,0,0,38,95,74,0
2021-01-31,2,1294,0,363,0,0,0,0,1,1,0,0,0,232,25986,100025,0,0,0,0,0,39,96,74,0
2021-02-01,14,3929,0,1101,0,0,0,0,3,5,6,0,0,246,27087,103954,0,0,0,0,0,42,101,80,0
2021-02-02,17,5805,0,1161,0,0,0,0,3,5,6,0,0,263,28248,109759,0,0,0,0,0,45,106,86,0
2021-02-03,12,3770,0,754,0,0,0,0,0,9,3,0,0,275,29002,113529,0,0,0,0,0,45,115,89,0
2021-02-04,24,6645,0,1329,0,0,0,0,2,13,7,0,0,299,30331,120174,0,0,0,0,0,47,128,96,0
2021-02-05,12,5665,0,1133,0,0,0,0,3,5,3,0,0,311,31464,125839,0,0,0,0,0,50,133,99,0
2021-02-06,1,2150,0,430,0,0,0,0,0,0,1,0,0,312,31894,127989,0,0,0,0,0,50,133,100,0
2021-02-07,3,1735,0,347,0,0,0,0,0,2,1,0,0,315,32241,129724,0,0,0,0,0,50,135,101,0
2021-02-08,20,5850,0,1170,0,0,0,0,0,7,11,0,0,335,33411,135574,0,0,0,0,0,50,142,112,0
2021-02-09,20,3660,0,732,0,0,0,0,0,13,6,0,0,355,34143,139234,0,0,0,0,0,50,155,118,0
2021-02-10,9,5546,0,1270,0,0,0,0,1,8,0,0,0,364,35413,144780,0,0,0,0,0,51,163,118,0
2021-02-11,13,4511,0,1033,0,0,0,0,2,7,4,0,0,377,36446,149291,0,0,0,0,0,53,170,122,0
2021-02-12,15,3135,0,627,0,0,0,0,1,7,6,0,0,392,37073,152426,0,0,0,0,0,54,177,128,0
2021-02-13,8,1760,0,352,0,0,0,0,2,5,1,0,0,400,37425,154186,0,0,0,0,0,56,182,129,0
2021-02-14,6,1390,0,278,0,0,0,0,1,2,3,0,0,406,37703,155576,0,0,0,0,0,57,184,132,0
2021-02-15,12,3325,0,665,0,0,0,0,2,3,3,0,0,418,38368,158901,0,0,0,0,0,59,187,135,0
2021-02-16,11,2670,0,534,0,0,0,0,4,4,3,0,0,429,38902,161571,0,0,0,0,0,63,191,138,0
2021-02-17,29,2985,0,597,0,0,0,0,4,16,6,0,0,458,39499,164556,0,0,0,0,0,67,207,144,0
2021-02-18,17,4380,0,876,0,0,0,0,3,6,5,0,0,475,40375,168936,0,0,0,0,0,70,213,149,0
2021-02-19,10,3125,0,625,0,0,0,0,1,6,3,0,0,485,41000,172061,0,0,0,0,0,71,219,152,0
2021-02-20,2,1750,0,350,0,0,0,0,0,2,0,0,0,487,41350,173811,0,0,0,0,0,71,221,152,0
2021-02-21,3,1595,0,319,0,0,0,0,1,1,1,0,0,490,41669,175406,0,0,0,0,0,72,222,153,0
2021-02-22,19,3685,0,737,0,0,0,0,5,6,7,0,0,509,42406,179091,0,0,0,0,0,77,228,160,0
2021-02-23,10,3075,0,615,0,0,0,0,0,6,3,0,0,519,43021,182166,0,0,0,0,0,77,234,163,0
2021-02-24,13,4210,0,842,0,0,0,0,1,7,4,0,0,532,43863,186376,0,0,0,0,0,78,241,167,0
2021-02-25,18,3535,0,707,0,0,0,0,1,10,7,0,0,550,44570,189911,0,0,0,0,0,79,251,174,0
2021-02-26,19,3495,0,699,0,0,0,0,1,6,9,0,0,569,45269,193406,0,0,0,0,0,80,257,183,0
2021-02-27,8,1955,0,391,0,0,0,0,1,4,3,0,0,577,45660,195361,0,0,0,0,0,81,261,186,0
2021-02-28,7,1740,0,348,0,0,0,0,0,7,0,0,0,584,46008,197101,0,0,0,0,0,81,268,186,0
2021-03-01,9,5130,0,1026,0,0,0,0,4,3,2,0,0,593,47034,202231,0,0,0,0,0,85,271,188,0
2021-03-02,29,3740,0,748,0,0,0,0,4,13,11,0,0,622,47782,205971,0,0,0,0,0,89,284,199,0
2021-03-03,17,6085,0,1217,0,0,0,0,1,6,3,0,0,639,48999,212056,0,0,0,0,0,90,290,202,0
2021-03-04,18,4570,0,914,0,0,0,0,3,10,5,0,0,657,49913,216626,0,0,0,0,0,93,300,207,0
2021-03-05,30,4385,0,877,0,0,0,0,4,10,11,0,0,687,50790,221011,0,0,0,0,0,97,310,218,0
2021-03-06,2,2130,0,426,0,0,0,0,0,1,1,0,0,689,51216,223141,0,0,0,0,0,97,311,219,0
2021-03-07,3,2100,0,420,0,0,0,0,2,0,1,0,0,692,51636,225241,0,0,0,0,0,99,311,220,0
2021-03-08,14,4810,0,962,0,0,0,0,2,8,4,0,0,706,52598,230051,0,0,0,0,0,101,319,224,0
2021-03-09,12,4040,0,808,0,0,0,0,3,3,5,0,0,718,53406,234091,0,0,0,0,0,104,322,229,0
2021-03-10,15,4800,0,960,0,0,0,0,1,11,3,0,0,733,54366,238891,0,0,0,0,0,105,333,232,0
2021-03-11,9,4300,0,860,0,0,0,0,1,7,1,0,0,742,55226,243191,0,0,0,0,0,106,340,233,0
2021-03-12,17,2590,0,518,0,0,0,0,0,12,5,0,0,759,55744,245781,0,0,0,0,0,106,352,238,0
2021-03-13,4,2420,0,484,0,0,0,0,1,1,2,0,0,763,56228,248201,0,0,0,0,0,107,353,240,0
2021-03-14,2,2295,0,459,0,0,0,0,0,1,1,0,0,765,56687,250496,0,0,0,0,0,107,354,241,0
2021-03-15,17,5645,0,1129,0,0,0,0,2,11,4,0,0,782,57816,256141,0,0,0,0,0,109,365,245,0
2021-03-16,23,5120,0,1024,0,0,0,0,2,12,7,1,0,805,58840,261261,0,0,0,0,0,111,377,252,1
2021-03-17,14,4140,0,828,0,0,0,0,2,8,4,0,0,819,59668,265401,0,0,0,0,0,113,385,256,1
2021-03-18,19,4810,0,962,0,0,0,0,2,10,7,0,0,838,60630,270211,0,0,0,0,0,115,395,263,1
2021-03-19,18,6415,0,1283,0,0,0,0,2,9,5,0,0,856,61913,276626,0,0,0,0,0,117,404,268,1
2021-03-20,2,2675,0,535,0,0,0,0,0,2,0,0,0,858,62448,279301,0,0,0,0,0,117,406,268,1
2021-03-21,3,3530,0,706,0,0,0,0,0,3,0,0,0,861,63154,282831,0,0,0,0,0,117,409,268,1
2021-03-22,26,5490,0,1098,0,0,0,0,5,10,10,0,0,887,64252,288321,0,0,0,0,0,122,419,278,1
2021-03-23,19,5270,0,1054,0,0,0,0,2,12,4,0,0,906,65306,293591,0,0,0,0,0,124,431,282,1
2021-03-24,17,4955,0,991,0,0,0,0,1,13,3,0,0,923,66297,298546,0,0,0,0,0,125,444,285,1
2021-03-25,17,4955,0,991,0,0,0,0,0,8,4,0,0,940,67288,303501,0,0,0,0,0,125,452,289,1
2021-03-26,9,5525,0,1105,0,0,0,0,4,4,1,0,0,949,68393,309026,0,0,0,0,0,129,456,290,1
2021-03-27,6,3110,0,622,0,0,0,0,2,4,0,0,0,955,69015,312136,0,0,0,0,0,131,460,290,1
2021-03-28,4,3340,0,668,0,0,0,0,1,1,1,0,0,959,69683,315476,0,0,0,0,0,132,461,291,1
2021-03-29,29,6090,0,1218,0,0,0,0,5,17,7,0,0,988,70901,321566,0,0,0,0,0,137,478,298,1
2021-03-30,27,5810,0,1162,0,0,0,0,5,10,10,0,0,1015,72063,327376,0,0,0,0,0,142,488,308,1
2021-03-31,19,9570,0,1914,0,0,0,0,2,10,5,0,0,1034,73977,336946,0,0,0,0,0,144,498,313,1
2021-04-01,15,7190,0,1438,0,0,0,0,4,8,3,0,0,1049,75415,344136,0,0,0,0,0,148,506,316,1
2021-04-02,12,6680,0,1336,0,0,0,0,4,6,1,0,0,1061,76751,350816,0,0,0,0,0,152,512,317,1
2021-04-03,3,4785,0,957,0,0,0,0,0,2,1,0,0,1064,77708,355601,0,0,0,0,0,152,514,318,1
2021-04-04,5,3965,0,793,1,0,0,0,1,2,0,0,0,1069,78501,359566,0,1,0,0,0,153,516,318,1
2021-04-05,11,2855,0,571,0,0,0,0,4,7,0,0,0,1080,79072,362421,0,1,0,0,0,157,523,318,1
2021-04-06,13,5185,0,1037,0,0,0,0,7,4,2,0,0,1093,80109,367606,0,1,0,0,0,164,527,320,1
2021-04-07,15,7800,0,1560,0,0,0,0,4,6,1,0,0,1108,81669,375406,0,1,0,0,0,168,533,321,1
2021-04-08,15,7210,0,1442,0,0,0,0,2,8,4,0,0,1123,83111,382616,0,1,0,0,0,170,541,325,1
2021-04-09,5,6800,0,1360,0,0,0,0,1,2,1,0,0,1128,84471,389416,0,1,0,0,0,171,543,326,1
2021-04-10,11,6755,0,1351,0,0,0,0,1,5,0,0,0,1139,85822,396171,0,1,0,0,0,172,548,326,1
2021-04-11,3,4185,0,837,0,0,0,0,0,3,0,0,0,1142,86659,400356,0,1,0,0,0,172,551,326,1
2021-04-12,19,6500,0,1300,0,0,0,1,5,7,6,0,0,1161,87959,406856,0,1,0,0,1,177,558,332,1
2021-04-13,23,5035,0,1007,0,0,0,0,4,11,6,0,0,1184,88966,411891,0,1,0,0,1,181,569,338,1
2021-04-14,28,7070,0,1414,0,0,0,0,3,19,6,0,0,1212,90380,418961,0,1,0,0,1,184,588,344,1
2021-04-15,28,7365,0,1473,0,0,0,0,10,15,3,0,0,1240,91853,426326,0,1,0,0,1,194,603,347,1
2021-04-16,19,7290,0,1458,0,0,0,0,5,8,5,0,0,1259,93311,433616,0,1,0,0,1,199,611,352,1
2021-04-17,8,5625,0,1125,0,0,0,0,4,3,1,0,0,1267,94436,439241,0,1,0,0,1,203,614,353,1
2021-04-18,15,7515,0,1503,0,0,0,1,3,4,1,0,0,1282,95939,446756,0,1,0,0,2,206,618,354,1
2021-04-19,26,6685,0,1337,0,0,0,0,6,14,2,0,0,1308,97276,453441,0,1,0,0,2,212,632,356,1
2021-04-20,8,3725,0,745,0,0,0,0,0,6,2,0,0,1316,98021,457166,0,1,0,0,2,212,638,358,1
2021-04-21,6,2585,0,517,0,0,0,0,1,5,0,0,0,1322,98538,459751,0,1,0,0,2,213,643,358,1
2021-04-22,15,6655,0,1331,0,0,0,2,5,7,1,0,0,1337,99869,466406,0,1,0,0,4,218,650,359,1
2021-04-23,11,6380,0,1276,0,0,0,0,2,6,3,0,0,1348,101145,472786,0,1,0,0,4,220,656,362,1
2021-04-24,5,5440,0,1088,0,0,0,0,4,1,0,0,0,1353,102233,478226,0,1,0,0,4,224,657,362,1
2021-04-25,18,11075,0,2215,0,0,0,0,4,3,2,0,0,1371,104448,489301,0,1,0,0,4,228,660,364,1
2021-04-26,18,6550,0,1310,0,0,0,0,5,11,2,0,0,1389,105758,495851,0,1,0,0,4,233,671,366,1
2021-04-27,14,7715,0,1543,0,0,0,0,1,5,6,0,0,1403,107301,503566,0,1,0,0,4,234,676,372,1
2021-04-28,24,6720,0,1344,0,0,0,0,6,11,5,0,0,1427,108645,510286,0,1,0,0,4,240,687,377,1
2021-04-30,3,1040,0,208,0,0,0,0,1,2,0,0,0,1430,108853,511326,0,1,0,0,4,241,689,377,1
2021-05-01,4,9475,0,1895,0,0,0,0,3,1,0,0,0,1434,110748,520801,0,1,0,0,4,244,690,377,1
2021-05-02,9,3380,0,676,0,0,0,0,2,2,2,0,0,1443,111424,524181,0,1,0,0,4,246,692,379,1
2021-05-03,17,5680,0,1136,0,0,0,0,1,13,3,0,0,1460,112560,529861,0,1,0,0,4,247,705,382,1
2021-05-04,15,5710,0,1142,0,0,0,0,2,9,3,0,0,1475,113702,535571,0,1,0,0,4,249,714,385,1
2021-05-05,16,8585,0,1717,0,0,0,0,5,5,5,0,0,1491,115419,544156,0,1,0,0,4,254,719,390,1
2021-05-06,17,5650,0,1130,0,0,0,0,7,4,6,0,0,1508,116549,549806,0,1,0,0,4,261,723,396,1
2021-05-07,10,5350,0,1070,0,0,0,0,2,3,5,0,0,1518,117619,555156,0,1,0,0,4,263,726,401,1
2021-05-08,5,5040,0,1008,0,0,0,0,0,1,2,0,0,1523,118627,560196,0,1,0,0,4,263,727,403,1
2021-05-09,1,1940,0,388,0,0,0,0,1,0,0,0,0,1524,119015,562136,0,1,0,0,4,264,727,403,1
2021-05-10,21,4785,0,957,0,0,0,0,6,11,4,0,0,1545,119972,566921,0,1,0,0,4,270,738,407,1
2021-05-11,0,2365,0,473,0,0,0,0,0,0,0,0,0,1545,120445,569286,0,1,0,0,4,270,738,407,1
2021-05-13,5,2150,0,430,0,0,0,0,1,4,0,0,0,1550,120875,571436,0,1,0,0,4,271,742,407,1
2021-05-14,10,8675,0,1735,0,0,0,0,1,7,2,0,0,1560,122610,580111,0,1,0,0,4,272,749,409,1
2021-05-15,9,5500,0,1100,0,0,0,0,0,3,0,0,0,1569,123710,585611,0,1,0,0,4,272,752,409,1
2021-05-16,2,2180,0,436,0,0,0,0,2,0,0,0,0,1571,124146,587791,0,1,0,0,4,274,752,409,1
2021-05-17,16,4210,0,842,0,0,0,0,6,9,1,0,0,1587,124988,592001,0,1,0,0,4,280,761,410,1
2021-05-18,14,5370,0,1074,0,0,0,0,5,5,3,0,0,1601,126062,597371,0,1,0,0,4,285,766,413,1
2021-05-19,10,6580,0,1316,0,0,0,0,3,5,0,0,0,1611,127378,603951,0,1,0,0,4,288,771,413,1
2021-05-20,12,6185,0,1237,0,0,0,0,5,5,0,0,0,1623,128615,610136,0,1,0,0,4,293,776,413,1
2021-05-21,17,4240,0,848,0,0,0,0,5,12,0,0,0,1640,129463,614376,0,1,0,0,4,298,788,413,1
2021-05-22,5,3670,0,734,0,0,0,0,2,1,0,0,0,1645,130197,618046,0,1,0,0,4,300,789,413,1
2021-05-23,0,2150,0,430,0,0,0,0,0,0,0,0,0,1645,130627,620196,0,1,0,0,4,300,789,413,1
2021-05-24,7,4215,0,843,0,0,0,0,3,1,2,0,0,1652,131470,624411,0,1,0,0,4,303,790,415,1
2021-05-28,1,815,0,163,0,0,0,0,0,0,1,0,0,1653,131633,625226,0,1,0,0,4,303,790,416,1
2021-05-29,4,4985,0,997,0,0,0,0,2,1,0,0,0,1657,132630,630211,0,1,0,0,4,305,791,416,1
2021-05-30,1,1240,0,248,0,0,0,0,0,1,0,0,0,1658,132878,631451,0,1,0,0,4,305,792,416,1
2021-05-31,4,1435,0,287,0,0,0,0,2,1,1,0,0,1662,133165,632886,0,1,0,0,4,307,793,417,1
2021-06-01,12,4565,0,913,0,0,0,0,6,4,1,0,0,1674,134078,637451,0,1,0,0,4,313,797,418,1
2021-06-02,10,6275,0,1255,0,0,0,0,3,5,2,0,0,1684,135333,643726,0,1,0,0,4,316,802,420,1
2021-06-03,11,5060,0,1012,0,0,0,0,4,4,3,0,0,1695,136345,648786,0,1,0,0,4,320,806,423,1
2021-06-04,19,6485,0,1297,0,0,0,0,6,6,4,0,0,1714,137642,655271,0,1,0,0,4,326,812,427,1
2021-06-05,0,1235,0,247,0,0,0,0,0,0,0,0,0,1714,137889,656506,0,1,0,0,4,326,812,427,1
2021-06-06,0,1615,0,323,0,0,0,0,0,0,0,0,0,1714,138212,658121,0,1,0,0,4,326,812,427,1
2021-06-07,2,3740,0,748,0,0,0,0,2,0,0,0,0,1716,138960,661861,0,1,0,0,4,328,812,427,1
2021-06-08,19,6285,0,1257,0,0,0,1,3,6,5,0,0,1735,140217,668146,0,1,0,0,5,331,818,432,1
2021-06-09,13,5910,0,1182,0,0,0,1,3,7,1,0,0,1748,141399,674056,0,1,0,0,6,334,825,433,1
2021-06-10,7,2590,0,518,0,0,0,1,1,3,1,0,0,1755,141917,676646,0,1,0,0,7,335,828,434,1
2021-06-17,3,1010,0,202,0,0,0,0,1,2,0,0,0,1758,142119,677656,0,1,0,0,7,336,830,434,1
2021-06-18,9,4170,0,834,0,0,0,0,3,2,3,0,0,1767,142953,681826,0,1,0,0,7,339,832,437,1
2021-06-19,4,3105,0,621,0,0,0,0,1,3,0,0,0,1771,143574,684931,0,1,0,0,7,340,835,437,1
2021-06-20,2,1130,0,226,0,0,0,0,0,0,2,0,0,1773,143800,686061,0,1,0,0,7,340,835,439,1
2021-06-21,9,4515,0,903,0,0,0,0,3,5,1,0,0,1782,144703,690576,0,1,0,0,7,343,840,440,1
2021-06-22,14,3795,0,759,0,0,0,0,2,10,2,0,0,1796,145462,694371,0,1,0,0,7,345,850,442,1
2021-06-23,13,4590,0,918,0,0,0,2,2,3,4,0,0,1809,146380,698961,0,1,0,0,9,347,853,446,1
2021-06-24,20,3695,0,739,0,0,0,0,4,7,6,0,0,1829,147119,702656,0,1,0,0,9,351,860,452,1
2021-06-25,23,8140,0,1628,0,0,0,0,1,16,3,0,0,1852,148747,710796,0,1,0,0,9,352,876,455,1
2021-06-26,3,1950,0,390,0,0,0,0,1,0,1,0,0,1855,149137,712746,0,1,0,0,9,353,876,456,1
2021-06-27,1,935,0,187,0,0,0,0,1,0,0,0,0,1856,149324,713681,0,1,0,0,9,354,876,456,1
2021-06-28,18,2660,0,532,0,0,0,1,2,13,2,0,0,1874,149856,716341,0,1,0,0,10,356,889,458,1
2021-06-29,28,2075,0,415,0,0,0,0,4,16,7,0,0,1902,150271,718416,0,1,0,0,10,360,905,465,1
2021-07-13,1,600,0,120,0,0,0,0,0,1,0,0,0,1903,150391,719016,0,1,0,0,10,360,906,465,1
2021-07-14,5,2355,0,471,0,0,0,0,3,1,1,0,0,1908,150862,721371,0,1,0,0,10,363,907,466,1
2021-07-15,11,2110,0,422,0,0,0,1,3,4,3,0,0,1919,151284,723481,0,1,0,0,11,366,911,469,1
2021-07-16,4,2025,0,405,0,0,0,0,3,1,0,0,0,1923,151689,725506,0,1,0,0,11,369,912,469,1
2021-07-17,0,1000,0,200,0,0,0,0,0,0,0,0,0,1923,151889,726506,0,1,0,0,11,369,912,469,1
2021-07-18,13,9900,0,1980,0,0,0,0,1,6,0,0,0,1936,153869,736406,0,1,0,0,11,370,918,469,1
2021-07-19,11,2395,0,479,0,0,0,0,7,3,1,0,0,1947,154348,738801,0,1,0,0,11,377,921,470,1
2021-07-20,12,3825,0,765,0,0,0,0,3,6,2,0,0,1959,155113,742626,0,1,0,0,11,380,927,472,1
2021-07-21,12,3915,0,783,0,0,0,0,4,4,4,0,0,1971,155896,746541,0,1,0,0,11,384,931,476,1
2021-07-22,7,4105,0,821,0,0,0,0,1,2,2,0,0,1978,156717,750646,0,1,0,0,11,385,933,478,1
2021-07-23,9,3970,0,794,0,0,0,1,2,3,2,0,0,1987,157511,754616,0,1,0,0,12,387,936,480,1
2021-07-24,3,165,0,33,0,0,0,0,2,0,0,0,0,1990,157544,754781,0,1,0,0,12,389,936,480,1
2021-08-09,15,2770,0,554,0,0,0,0,4,8,3,0,0,2005,158098,757551,0,1,0,0,12,393,944,483,1
2021-08-10,10,2845,0,569,0,0,0,0,4,5,1,0,0,2015,158667,760396,0,1,0,0,12,397,949,484,1
2021-08-11,37,3270,0,654,0,0,0,0,20,15,2,0,0,2052,159321,763666,0,1,0,0,12,417,964,486,1
2021-08-12,8,2935,0,587,0,0,0,0,2,3,3,0,0,2060,159908,766601,0,1,0,0,12,419,967,489,1
2021-08-13,0,50,0,10,0,0,0,0,0,0,0,0,0,2060,159918,766651,0,1,0,0,12,419,967,489,1
2021-08-16,10,2540,0,508,0,0,0,0,2,6,2,0,0,2070,160426,769191,0,1,0,0,12,421,973,491,1
2021-08-17,17,2935,0,587,0,0,0,0,3,9,5,0,0,2087,161013,772126,0,1,0,0,12,424,982,496,1
2021-08-18,11,2060,0,412,0,0,0,0,3,8,0,0,0,2098,161425,774186,0,1,0,0,12,427,990,496,1
2021-08-19,11,570,0,114,0,0,0,0,2,6,3,0,0,2109,161539,774756,0,1,0,0,12,429,996,499,1
2021-08-20,0,30,0,6,0,0,0,0,0,0,0,0,0,2109,161545,774786,0,1,0,0,12,429,996,499,1